co je to ?	¿ qué es eso ?
vždy jsem dávala přednost záhadným typům .	siempre me gustaron más los personajes misteriosos .
nikdy jsem neměl rád biologii .	nunca me gustó la biología .
kdyby svět nebyl jaký je , mohl bych věřit kdekomu .	si el mundo no fuera como es , yo podría confiar en cualquiera .
kdykoli najdu něco , co se mi líbí , je to příliš drahé .	cada vez que encuentro algo que me gusta , es demasiado caro .
možná je to pro něho stejné .	quizás sea lo mismo para él .
nevěděla jsem , odkud to přišlo .	no sabía de dónde venía eso .
to se mi nelíbilo .	no me gustaba .
nelíbilo se mi to .	no me gustaba .
chtěl jsi mi povědět o svobodě ?	¿ querías hablarme de libertad ?
potřebuju ti položit hloupou otázku .	necesito hacerte una pregunta tonta .
musím se tě zeptat něco hloupého .	necesito hacerte una pregunta tonta .
líbí se mi světlo svíček .	me gusta la luz de las velas .
kde je problém ?	¿ dónde está el problema ?
to není žádné velké překvapení , nebo ano ?	eso no es ninguna gran sorpresa , ¿ o sí ?
nechtěl jsem , aby se stalo tohle .	yo no quería que pasase esto .
opravdu se musíš ptát , abys znal odpověď ?	¿ realmente necesitas preguntar para saber la respuesta ?
je to překvapení .	es una sorpresa .
jednou na mě zapomeneš .	me olvidarás algún día .
potřebuješ , abych ti dal nějaké peníze ?	¿ necesitas que te dé algo de dinero ?
svět je blázinec .	el mundo es una jaula de locos .
našels mě , kde nikdo nehledal .	me encontraste donde nadie estaba buscando .
našel jsi mne , kde nikdo nehledal .	me encontraste donde nadie estaba buscando .
to se mi moc líbí .	me gusta mucho .
to se mi opravdu líbí .	me gusta mucho .
moc se mi líbí .	me gusta mucho .
děkuji , to je všechno .	gracias , es todo .
děkuji , to je vše .	gracias , es todo .
lépe být nenáviděn pro to , co jsi , než milován pro to , co nejsi .	mejor ser odiado por lo que eres que querido por lo que no eres .
kde můžeme telefonovat ?	¿ dónde podemos telefonear ?
volej policii !	¡ llama a la policía !
moje boty jsou příliš malé , potřebuju nové .	mis zapatos son muy pequeños , necesito otros nuevos .
měl jsi mě poslechnout .	deberías haberme escuchado .
měla jsi mě poslechnout .	deberías haberme escuchado .
když se chce , tak to jde .	querer es poder .
nepravidelná slovesa se učím nerada .	no me gusta aprender los verbos irregulares .
život je krásný !	la vida es bella .
život je krásný .	la vida es bella .
potřebuju tvoji pomoc .	necesito tu ayuda .
svou práci mám opravdu rád .	me gusta mucho mi trabajo .
potřebuji nový počítač .	necesito un nuevo ordenador .
je bohatý , peníze nepotřebuje !	es rico , ¡ no necesita dinero !
cože ? ty ještě neumíš řídit ?	¿ qué ? ¿ todavía no sabes conducir ?
kam jdeš ?	¿ adónde vas ?
kdy se dá říci , že má člověk potíže s alkoholem ?	¿ cuándo se puede decir que una persona tiene problemas con el alcohol ?
loučení jsou vždy smutná .	las despedidas siempre son tristes .
tohle mě baví míň než se starat o děti .	esto me gusta menos que cuidar niños .
potřebujeme sanitku .	necesitamos una ambulancia .
potřebuju tvou radu .	necesito tu consejo .
kdo se směje naposled , ten se směje nejlíp .	quien ríe último , ríe mejor .
odkud jseš ?	¿ de dónde eres ?
kde bydlíš ?	¿ dónde vives ?
obecně řečeno , chlapcům se líbí dlouhovlasá děvčata .	en general a los chicos les gustan las chicas de cabello largo .
nepochybně musíš být po celodenní práci vyčerpaný .	sin duda debes de estar agotado después de trabajar todo el día .
jsi propuštěn .	estás despedido .
to je kniha o hvězdách .	es un libro acerca de las estrellas .
provdal svou dceru za boháče .	él casó a su hija con un hombre rico .
v trojrozměrném prostoru síly jako elektromagnetismus operují jen trojrozměrně a chovají se dle tradičních zákonů fyziky .	en una realidad tridimensional , fuerzas como el electromagnetismo operan sólo tridimensionalmente y se comportan según las leyes tradicionales de la física .
můj šéf zamítnul rozpočet pro nový projekt .	mi jefe rechazó el presupuesto para el nuevo proyecto .
navštívil jsem hrob svého otce .	he visitado la tumba de mi padre .
válka je zločin proti lidskosti .	la guerra es un crimen contra la humanidad .
moje teta má tři děti .	mi tía tiene tres hijos .
pokusili se o atentát na prezidenta .	intentaron asesinar al presidente .
nevím , kde bydlí .	no sé dónde vive .
on by to rád slyšel .	él estaría contento de escuchar eso .
moje hodinky potřebujou opravit .	mi reloj necesita una reparación .
šťastný nový rok !	¡ feliz año nuevo !
život bez lásky nemá žádný smysl .	una vida sin amor no tiene ningún sentido .
fakt potřebuju někoho praštit .	realmente necesito golpear a alguien .
kde jsou mé brýle ?	¿ dónde están mis gafas ?
rád cestuje . já taky .	le gusta viajar . a mí me gusta también .
rád bych , kdyby ses s ním setkal , abys vyslechl jeho názor .	me gustaría que te reunieras con él para que escuches su opinión .
jsi poslední osoba , kterou bych býval myslel , že tu potkám .	eres la última persona que habría pensado encontrar aquí .
toto je , co jsem chtěl .	esto es lo que quería .
není zač .	de nada .
překvapilo nás , když jsme slyšeli , co se stalo .	nos sorprendió escuchar lo que había pasado .
nesmíš tolik jíst .	no debes comer tanto .
potřebuju to do zítřka .	lo necesito antes de mañana .
přál bych si , aby mi psal častěji .	ojalá él me escribiese más seguido .
přála bych si , aby mi psal častěji .	ojalá él me escribiese más seguido .
kéž bychom mohli odejít z tohoto hrozného místa .	ojalá pudiéramos irnos de este horrible lugar .
ta dáma vypadala smutně a unaveně .	la señorita se veía triste , y cansada .
na tu práci nebylo zapotřebí o nic méně než tři sta dolarů .	se necesitaban nada menos que trescientos dólares para ese trabajo .
to dítě dosud neumí používat lžíci .	el bebé todavía no puede usar una cuchara .
kdybych byl měl trochu víc peněz , byl bych to koupil .	si hubiese tenido un poco más de dinero , lo habría comprado .
kdybych měl o trochu víc peněz , koupil bych to .	si hubiese tenido un poco más de dinero , lo habría comprado .
už jdu .	ya voy .
tvé chování má daleko k mým očekáváním .	tu comportamiento está lejos de mis expectativas .
kvůli tomu se nepotřebuješ trápit .	no necesitas preocuparte por causa de eso .
tady bys čekat neměl .	no debes esperar aquí .
co bys udělal na mém místě ?	¿ qué harías tú en mi lugar ?
co bys udělala na mém místě ?	¿ qué harías tú en mi lugar ?
pokusila se o sebevraždu .	ella intentó suicidarse .
zkusila se zabít .	ella intentó suicidarse .
piješ alkohol ?	¿ bebes alcohol ?
promiňte . nemyslel jsem , že je to vaše místo .	discúlpeme . no pensé que fuera su asiento .
miloval ji převelice .	él la quería muchísimo .
dělal , že neposlouchá , co říkám .	fingió no escuchar lo que yo decía .
dělal , že neslyší , co říkám .	fingió no escuchar lo que yo decía .
předstíral , že neslyšel , co jsem řekl .	fingió no escuchar lo que yo decía .
na hraní karet potřebujeme ještě jednu osobu .	para jugar a las cartas necesitamos una persona más .
máš dobrou paměť .	tienes buena memoria .
bolí mě hlava .	me duele la cabeza .
má mnoho chyb , ale i tak se mi líbí .	él tiene muchos defectos , pero aun así me gusta .
bojí se toho psa .	tiene miedo de ese perro .
když ho uslyšíš mluvit francouzsky , bude se ti zdát , že je z francie .	si lo escuchas hablando francés , te parecerá que es de francia .
mám bolest v zádech .	tengo dolor de espalda .
kéž bych byl tak fešný jako on .	ojalá fuera tan guapo como él .
kéž bych byl tak hezký jako on .	ojalá fuera tan guapo como él .
choval se hloupě .	él se comportó estúpidamente .
jeho chování je občas zvláštní .	su comportamiento es extraño a veces .
její otec jí nedovolil jít sama do kina .	su padre no permitió que ella fuera sola al cine .
je možné , že mi lhala .	es posible que ella me haya mentido .
koluje pověst , že si našla nové zaměstnání .	circula el rumor de que ella ha conseguido un nuevo empleo .
můj otec neřídí ze strachu z nehod .	mi padre no conduce por miedo a los accidentes .
obvykle dosáhla , čeho chtěla .	ella conseguía hábilmente lo que quería .
ještě nepřišel .	ella aún no ha venido .
poslouchal s uchem přitisklým ke dveřím .	él escuchaba con la oreja pegada a la puerta .
on mi lhal mnohokrát .	él me ha mentido muchas veces .
mockrát mi lhal .	él me ha mentido muchas veces .
teď zrovna obědvá .	ella está almorzando ahora mismo .
chtěla jim pomoci .	ella quería ayudarlos .
potřebuju službičku .	necesito un favor .
zdá se , že není žádná potřeba jít .	parece que no hay ninguna necesidad de ir .
on má strach z toho psa .	a él le da miedo ese perro .
potřebuješ hodně peněz ?	¿ necesitas mucho dinero ?
řekni mi pravdu .	dime la verdad .
pověz mi pravdu .	dime la verdad .
ať ti to říkám , kolikrát chci , stejně mě neposloucháš .	por más que te lo digo no me escuchas .
motor chcípnul .	el motor se acabó parando .
kéž by se byl zúčastnil přednášky .	ojalá él hubiera participado en la conferencia .
potřebuju někoho , kdo umí francouzsky .	necesito a alguien que sepa hablar francés .
bez tvé pomoci bych neuspěl .	sin tu ayuda yo no habría tenido éxito .
dívka poslouchala hudbu a chlapec četl knihu .	la niña escuchaba música y el niño leía un libro .
seděla pod stromem .	ella estaba sentada bajo un árbol .
není dobré zkoušet vnucovat své myšlenky ostatním .	no está bien intentar imponer las ideas propias a los demás .
zrovna odešla .	ella acaba de salir .
chtěl , aby taxikář odbočil vlevo .	él quería que el taxista girase a la izquierda .
je nutno neztrácet naději .	no hay que perder la esperanza .
oba dva psi spí .	los dos perros duermen .
už měl dorazit .	él ya debería haber llegado .
nezapomeň mi napsat .	no te olvides de escribirme .
rád bych byl žurnalistou .	quisiera ser periodista .
ráda bych byla žurnalistkou .	quisiera ser periodista .
jak se jmenuje tato květina ?	¿ cómo se llama esta flor ?
jak se nazývá tato květina ?	¿ cómo se llama esta flor ?
rozdělili se do skupin o pěti lidech .	se dividieron en grupos de cinco personas .
potřebuješ-li peníze , půjčím ti je .	si necesitas dinero te lo presto .
měl bys navštívit lékaře .	necesitas que te vea un médico .
kéž bych mohl na koncert .	ojalá pudiera ir al concierto .
z toho či onoho důvodu se nevzali .	fuera cual fuera la razón , ellos no se casaron .
nesmíš se mu vysmívat .	no debes burlarte de él .
nedotýkej se mého kole .	no toques mi bicicleta .
neměl jsem utratit tolik peněz .	no debí haber gastado tanto dinero .
na koho čekáš ?	¿ a quién esperas ?
splatil jsem mu peníze , které jsem mu dlužil .	le pagué a él el dinero que le debía .
řidiči musí znát pravidla silničního provozu .	los conductores deben conocer las normas de circulación .
řidiči musejí znát pravidla dopravního provozu .	los conductores deben conocer las normas de circulación .
měsíc je krásný na podzim .	en otoño la luna es bonita .
kéž by zítra pršelo .	ojalá llueva mañana .
ať zítra prší .	ojalá llueva mañana .
stromy už shodily listí .	los árboles ya han soltado las hojas .
jestli potřebuješ slovník , půjčím ti můj starý .	si necesitas un diccionario , te presto el mío viejo .
jak se jmenuje tamhleten pták ?	¿ cómo se llama aquel pájaro ?
jak se nazývá tamhleten pták ?	¿ cómo se llama aquel pájaro ?
jak se říká tamhletomu ptákovi ?	¿ cómo se llama aquel pájaro ?
pokouší se o sebevraždu .	está intentando suicidarse .
k mému překvapení se oženil s překrásnou herečkou .	para mi sorpresa , él se casó con una bellísima actriz .
poslouchejme hudbu .	escuchemos música .
dopiv pivo , objednal si hned další .	acabando de beberse la cerveza , él pidió otra .
kdybych jen byl vyšel z domu o pět minut dříve .	ojalá hubiera salido de casa cinco minutos antes .
kéž bych byl vyšel z domu o pět minut dřív .	ojalá hubiera salido de casa cinco minutos antes .
koupil jsem to včera .	lo compré ayer .
jak se této rybě říká anglicky ?	¿ cómo se llama este pez en inglés ?
zde se nesmí kouřit .	aquí no se puede fumar .
usmáli se jeden na druhého .	se sonrieron el uno al otro .
usmáli se na sebe .	se sonrieron el uno al otro .
potřebujeme víc inflace ?	¿ necesitamos más inflación ?
co oči nevidí , to srdce nebolí .	ojos que no ven , corazón que no siente .
mám strach , že upadnu .	tengo miedo de caer .
bojím se pádu .	tengo miedo de caer .
je zřejmé , že jsi lhal .	es obvio que mentiste .
je zřejmé , že jsi lhala .	es obvio que mentiste .
jak on je !	¡ cómo come !
jak on je .	¡ cómo come !
potřebuji operaci ?	¿ necesito cirugía ?
potřebuje léky , ale nechce je .	él necesita medicación , pero no la quiere .
potřebuje žebřík .	él necesita una escalera .
potřebuje ručník .	él necesita una toalla .
potřebuje deštník .	él necesita un paraguas .
potřebuje brýle .	él necesita gafas .
potřebuje peníze .	él necesita dinero .
kolik potřebuješ ?	¿ cuánto necesitas ?
jsem daleko od stromu .	estoy lejos del árbol .
mám hlad !	¡ tengo hambre !
já jsem lin .	soy lin .
jsem ospalý .	estoy cansado .
cítím bolest v zádech .	siento un dolor en la espalda .
zapomněl jsem .	me olvidé .
zapomněla jsem .	me olvidé .
mám kabát , ale nemám klobouk .	tengo un abrigo , pero no tengo sombrero .
na to nemám čas , a navíc ani nemám peníze .	no tengo tiempo para eso , y además no tengo dinero .
chybíš mi .	te extraño .
potřebuju šálek horké kávy .	necesito una taza de café caliente .
potřebuju lékaře !	¡ necesito un medico !
potřebuju horkou čokoládu .	necesito un chocolate caliente .
potřebuju práci .	necesito un trabajo .
potřebuju zrcadlo , abych se mohl učesat .	necesito un espejo para peinarme .
potřebuju teď hned sestřičku .	necesito una enfermera ahora mismo .
potřebuju náplast .	necesito tiritas .
potřebuju lék proti průjmu .	necesito medicina para la diarrea .
potřebuji léky . kde je lékárna ?	necesito medicamentos . ¿ dónde está la farmacia ?
potřebuji peníze .	necesito dinero .
potřebuji víc času .	necesito más tiempo .
potřebuju prášky na spaní .	necesito medicina para el sueño .
potřebuju nějaký čas na rozmyšlenou .	necesito algún tiempo para pensarlo .
potřebuju klíče .	necesito las llaves .
zbývá nám ještě hodně jídla .	todavía nos queda mucha comida .
kéž bych byl chytrý .	ojalá fuera inteligente .
kéž bych byl tak bohatý jako on .	ojalá fuera tan rico como él .
je to důležité ?	¿ hay algo importante ?
potřeboval jsem tři hodiny , abych napsal tento dopis .	necesité tres horas para escribir esta carta .
zrovna jsem dorazil .	acabo de llegar .
jak se jmenuje tahle řeka ?	¿ cómo se llama este río ?
nezapomeň vrátit knihu do knihovny .	no te olvides de devolver el libro a la biblioteca .
neposlouchej ho , plácá nesmysly .	no le escuches , está diciendo insensateces .
bojí se svého otce .	él tiene miedo de su padre .
děti potřebujou lásku .	los niños necesitan amor .
neměj strach .	no tengas miedo .
poslouchejte , prosím , pozorně .	por favor , escuche con atención .
dívka se třásla strachem .	la niña temblaba de miedo .
slyšel jsi zprávy ?	¿ has escuchado las noticias ?
je mi do zpěvu .	tengo ganas de cantar .
chce se mi zpívat .	tengo ganas de cantar .
jak zvláštní je život !	¡ qué extraña es la vida !
chtěl bych vyměnit peníze .	quisiera cambiar dinero .
jsem ospalá .	estoy cansada .
poslouchejte , co říká učitel .	escuchen lo que dice el profesor .
kéž bych mohl jet do japonska .	ojalá pudiera ir a japón .
dosud jsem nic nenašel .	todavía no he encontrado nada .
ještě jsem nic nenašel .	todavía no he encontrado nada .
divné , že ? už jsme měli dorazit .	extraño , ¿ verdad ? ya deberíamos haber llegado .
divné , že ? už jsme tam měli být .	extraño , ¿ verdad ? ya deberíamos haber llegado .
tys ještě nedojedl ?	¿ todavía no has terminado de comer ?
ty ještě nemáš dojedeno ?	¿ todavía no has terminado de comer ?
poslouchám rádio .	estoy escuchando la radio .
mám hlad , protože jsem nesnídal .	tengo hambre porque no he desayunado .
mám hlad , protože jsem nejedl .	tengo hambre porque no he comido .
mám hlad , protože jsem nejedla .	tengo hambre porque no he comido .
tys ještě nedosnídal ?	¿ todavía no has terminado de desayunar ?
ty jsi ještě nedosnídal ?	¿ todavía no has terminado de desayunar ?
ty ještě nemáš dojedenou snídani ?	¿ todavía no has terminado de desayunar ?
potřebuje kabát .	ella necesita un abrigo .
potřebuje brýle , ale nechce je .	ella necesita gafas pero no las quiere .
chlapec poslouchá hudbu .	el niño está escuchando música .
maso ještě není .	la carne todavía no está .
rodiče poslouchají .	los padres están escuchando .
jejich starší dcera ještě není vdaná .	su hija mayor no está casada todavía .
poslouchají koncert .	están escuchando un concierto .
poslouchají rádio .	están escuchando la radio .
báli se toho velkého psa .	tenían miedo del perro grande .
měli strach z toho velkého psa .	tenían miedo del perro grande .
potřebujeme nůž na máslo .	necesitamos un cuchillo para la mantequilla .
potřebujeme se dohodnout .	necesitamos llegar a un acuerdo .
potřebujeme dosáhnout dohody .	necesitamos llegar a un acuerdo .
co potřebuješ ?	¿ qué necesitas ?
co musím udělat , abys mi věnovala pozornost ?	¿ qué tengo que hacer para que me prestes atención ?
ta židle potřebuje opravit .	esa silla necesita ser reparada .
moje chyba .	mi falta .
nezoufej , ještě není všechno ztraceno .	no desesperes , todavía no está todo perdido .
stromy jsou zelené .	los árboles son verdes .
chybí nůž .	falta un cuchillo .
schází nůž .	falta un cuchillo .
já mám rád psy , ale moje sestra má ráda kočky .	a mí me gustan los perros , pero a mi hermana le gustan los gatos .
stále ještě prší .	todavía llueve .
uvázal psa ke stromu .	el ató al perro a un árbol .
i dobří přátelé musí vynakládat úsilí , aby udrželi své přátelství .	aun los buenos amigos deben hacer un esfuerzo para mantener su amistad .
došel jí papír .	a ella se le acabó el papel .
jdi do prdele !	¡ vete a la mierda !
jak se jmenuje tahle ulice ?	¿ cómo se llama esta calle ?
kéž bych dovedla hrát na klavír tak dobře jako susie .	ojalá pudiera tocar el piano tan bien como susie .
kéž bych se s ní byl oženil .	ojalá me hubiera casado con ella .
potřebuju něco pro dítě .	necesito algo para un niño .
můj syn dosud neumí číst ani psát .	mi hijo todavía no sabe leer ni escribir .
toto kolo patří mému bratrovi .	esta bicicleta le pertenece a mi hermano .
nesouhlasím s tebou .	no estoy de acuerdo contigo .
já s tebou nesouhlasím .	no estoy de acuerdo contigo .
nezapomeň spláchnout .	no olvides tirar de la cadena .
zloděje chytili dnes ráno .	cogieron al ladrón esta mañana .
dosud vidím tvář své matky .	todavía puedo ver la cara de mi madre .
on stále ještě pracuje .	él todavía está trabajando .
stále ještě je v práci .	él todavía está en el trabajo .
jenom se dívám .	sólo estoy mirando .
z čeho se vyrábí máslo ?	cómo se hace la mantequilla ?
potřebuješ naši pomoc ?	¿ necesitas nuestra ayuda ?
potřebujete ho .	lo necesita .
má něco v ruce .	ella tiene algo en la mano .
v tomto hotelovém pokoji můžete slyšet moře .	usted puede escuchar el sonido del mar en esta habitación de hotel .
neměl ses udělat tak rychle .	no deberías haber acabado tan pronto .
pan smith měl říct pravdu .	el sr . smith debería haber dicho la verdad .
jeho bratr je ještě vyšší .	su hermano es aun más alto .
její bratr je ještě vyšší .	su hermano es aun más alto .
jejich bratr je ještě vyšší .	su hermano es aun más alto .
váš bratr je ještě vyšší .	su hermano es aun más alto .
co potřebujete ?	¿ qué necesita ?
co potřebuje ?	¿ qué necesita ?
stále ještě toho zbývá hodně udělat .	todavía queda mucho por hacer .
napsal knihu o číně .	él escribió un libro sobre china .
poslouchal jsem , ale neslyšel jsem nic .	escuché , pero no oí nada .
poslouchala jsem , ale nic jsem neslyšela .	escuché , pero no oí nada .
kéž bych dobře uměl zpívat .	ojalá pudiera yo cantar bien .
potřebujeme peníze .	necesitamos dinero .
jak se jmenuje tvoje dcera ?	¿ cómo se llama tu hija ?
pozorně poslouchala , když jsem jí chválil syna .	ella escuchó atentamente cuando alabé a su hijo .
v kolik jsi vstal ?	¿ a qué hora te levantaste ?
v kolik jsi vstala ?	¿ a qué hora te levantaste ?
poslouchám nejnovější björčinu písničku .	estoy escuchando la última canción de björk .
poslouchám nejnovější píseň od björk .	estoy escuchando la última canción de björk .
jak se jmenoval ten hotel ? já si nevzpomínám .	¿ cómo se llamaba el hotel ? no recuerdo .
bill vstal brzy , aby stihnul první vlak .	bill se levantó temprano para coger el primer tren .
bill si přivstal , aby stihnul první vlak .	bill se levantó temprano para coger el primer tren .
musíš odejít .	tienes que irte .
smíte kouřit v tamhletom pokoji , ale ne v tomto .	usted puede fumar en esa habitación , pero no debe fumar en ésta .
vzduch , jako i jídlo , je jednou ze základních lidských potřeb .	el aire , como la comida , es una necesidad humana básica .
co chybí ?	¿ qué falta ?
co schází ?	¿ qué falta ?
můj přítel už tu měl být .	mi amigo ya debería haber llegado .
už jsem tu píseň byl jednou slyšel .	yo ya había escuchado esa canción una vez .
nepij žádný alcohol .	no bebas nada de alcohol .
pokud vím , dosud není vdaná .	que yo sepa , ella todavía no está casada .
svou dovolenou jsme dosud nenaplánovali .	todavía no hemos planeado nuestras vacaciones .
nemusíš nic platit , je to zadarmo .	no tienes que pagar nada , es gratuito .
a žili šťastně až do smrti .	y colorín colorado , este cuento se ha acabado .
poslouchal jsi dnes ráno zprávy v rádiu ?	¿ escuchaste las noticias en la radio esta mañana ?
slyšel jsi dnes ráno zprávy v rádiu ?	¿ escuchaste las noticias en la radio esta mañana ?
dosud neznáme pravdu .	todavía no sabemos la verdad .
dosud nevíme pravdu .	todavía no sabemos la verdad .
kéž by tu byl .	ojalá él estuviera aquí .
grace ještě nepřišla .	grace todavía no ha venido .
nesnáší chování svého manžela .	ella no tolera el comportamiento de su marido .
kéž bych nebyl koupil něco tak zbytečného .	ojalá no hubiera comprado algo tan inútil .
dosud mi občas volá .	todavía me llama de vez en cuando .
jsem gay .	soy gay .
když se nebudeš chovat , budu ti muset dát zaracha .	si no te comportas te voy a tener que castigar .
chybí vidlička .	falta un tenedor .
zpívat jsem ho nikdy neslyšel .	nunca le he escuchado cantar .
autobus byl přecpaný . kéž bych byl jel taxíkem .	el ómnibus estaba repleto de gente . ojalá hubiera tomado un taxi .
dosud mi neodpověděl na dopis .	todavía no ha respondido a mi carta .
na dopis mi stále ještě neodpověděl .	todavía no ha respondido a mi carta .
kéž bych měl hodně peněz .	ojalá tuviera mucho dinero .
je to skvělá myšlenka .	es una gran idea .
příživníky tady nechceme .	aquí no queremos gorrones .
jsem hezčí než ty .	soy más bello que tú .
ještě se neprobudili .	todavía no se han despertado .
dosud se nevzbudily .	todavía no se han despertado .
slyšel jsem to v rádiu .	lo escuché en la radio .
slyšela jsem to v rádiu .	lo escuché en la radio .
nesmíš lhát .	no debes mentir .
nesmíš říkat lži .	no debes mentir .
jsi ještě mladý .	todavía eres joven .
ještě jsi mladá .	todavía eres joven .
alice svou sestru neposlouchala .	alice no estaba escuchando a su hermana .
kéž bych byl vyšší .	ojalá fuera más alto .
kéž bych byla vyšší .	ojalá fuera más alta .
kéž bychom měli zahradu !	¡ ojalá tuviéramos un jardín !
kéž bych znovu byl mladý .	ojalá yo fuera joven de nuevo .
musela být velmi mladá , když napsala tuto báseň .	ella debía de ser muy joven cuando escribió este poema .
neměj starost ! i když piju , mou schopnost řídit to neovlivňuje .	¡ no te preocupes ! aun si bebo , eso no afecta mi capacidad de conducir .
budu tě poslouchat , obzvlášť když se neshodneme .	te escucharé , sobre todo cuando no estemos de acuerdo .
ještě stále nebylo vidět žádné známky jara .	todavía no había ninguna señal visible de la primavera .
dítě dosud nedovede chodit .	el bebé todavía no puede andar .
dámy a pánové , rád bych , kdybyste vyslechli můj názor .	damas y caballeros , me gustaría que escuchasen mi opinión .
často mám noční můry .	a menudo tengo pesadillas .
potřebuju nové kolo .	necesito una bicicleta nueva .
potřebuju její pomoc .	necesito su ayuda .
potřebuju vaši pomoc .	necesito su ayuda .
potřebujeme , aby nám někdo pomohl .	necesitamos que alguien nos ayude .
tom dosud nedovede plavat .	tom todavía no sabe nadar .
tom stále ještě neumí plavat .	tom todavía no sabe nadar .
neměl jsi tam chodit .	no deberías haber ido allí .
měl jsi vyrazit o půl hodiny dřív .	deberías haber salido media hora antes .
často studuji při poslechu hudby .	yo frecuentemente estudio mientras escucho música .
dostavil jsem se příliš pozdě na to , abych slyšel jeho projev .	llegué demasiado tarde para escuchar su discurso .
stydím se za chování svého syna .	estoy avergonzada del comportamiento de mi hijo .
nechápu , proč se lidé bojí nových myšlenek . já se bojím starých .	no entiendo por qué la gente tiene miedo de nuevas ideas . a mí me dan miedo las viejas .
velvyslanec je upřímný člověk vyslaný do zahraničí , aby tam lhal pro dobro své země .	un embajador es un hombre honesto enviado al extranjero a mentir por el bien de su país .
můj otec měl ve zvyku vstávat z postele v šest , dokonce i v zimě .	mi padre acostumbraba a levantarse de la cama a las seis , aun en invierno .
nic z toho , co jsem slyšel na té schůzi , mě nepřimělo ke změně názoru .	nada de lo que escuché en la reunión me hizo cambiar de opinión .
jsi opilý !	¡ estás borracho !
zeptej se ho , jestli stále ještě bydlí v tokyu .	pregúntale si todavía viven en tokio .
kdyby tam býval byl , bývala bys chtěla přijít ?	¿ si él hubiera estado allí , habrías querido venir ?
potřebuji známku .	necesito un sello .
kéž bych ji byl viděl .	ojalá la hubiera visto .
slyšel jsem někoho křičet .	escuché a alguien gritar .
snažil jsem se mu naslouchat pozorně .	intenté escucharle atentamente .
kéž bych měl přítele jako ty .	ojalá tuviera un amigo como tú .
kéž bychom měli více času .	ojalá tuviéramos más tiempo .
mám velký hlad !	¡ tengo mucha hambre !
poslouchaje rádio , usnul jsem .	me dormí escuchando la radio .
poslouchajíc rádio , usnula jsem .	me dormí escuchando la radio .
měls být opatrnější .	deberías haber tenido más cuidado .
její nabídku jsi měl odmítnout .	deberías haber rechazado su oferta .
její nabídku jsi měla odmítnout .	deberías haber rechazado su oferta .
jejich nabídku jsi měl odmítnout .	deberías haber rechazado su oferta .
jejich nabídku jsi měla odmítnout .	deberías haber rechazado su oferta .
potřebuju shodit pár kilo .	necesito bajar un par de kilos .
proč jsi lhal ?	¿ por qué mentiste ?
proč jsi lhala ?	¿ por qué mentiste ?
tvou pomoc nepotřebuju .	no necesito tu ayuda .
vezmi si broskví , kolik chceš .	coge todos los melocotones que quieras .
ráda poslouchá hudbu .	a ella le gusta escuchar música .
můžu pít alkohol ?	¿ puedo beber alcohol ?
slyším tě , ale nevidím tě .	te escucho , pero no te veo .
hudba , kterou jsme poslouchali včera večer , byla nádherná .	fue maravillosa la música que escuchamos anoche .
je to velmi smutné .	es muy triste .
je velmi smutná .	ella está muy triste .
dosud mi občas napíše .	todavía me escribe de vez en cuando .
dnes mi chybí inspirace .	hoy me falta inspiración .
ještě jsem nejedl .	todavía no he comido .
když poslouchala mahlera , lyusya plakala .	lyusya lloraba mientras escuchaba a mahler .
lyusya plakala , poslouchajíc mahlera .	lyusya lloraba mientras escuchaba a mahler .
poslouchajíc mahlera , lyusya vždy přemýšlela o smrti a věčném životě .	escuchando a mahler , lyusya siempre pensaba en la muerte y en la vida eterna .
můžeš lhát všem ostatním , ale nemůžeš lhát sám sobě .	puedes mentir a todos los demás , pero no puedes mentirte a ti mismo .
co potřebuje nejvíc je dobré zaměstnání .	lo que más necesita es un buen trabajo .
ken mě nechtěl poslouchat .	ken no quería escucharme .
v nouzi poznáš přítele .	un amigo en la necesidad es un amigo de verdad .
dovolil jsem své sestře použít můj nový počítač .	le permití a mi hermana usar mi computadora nueva .
je něco , co ti musím říct , a vím , že se ti to nebude líbit .	hay algo que necesito decirte , y sé que no te va a gustar .
na počátku stvořil bůh nebe a zemi .	en el principio creó dios los cielos y la tierra .
dokonalý !	¡ perfecto !
kéž bych s ní byl mohl jít .	ojalá yo hubiera podido ir con ella .
kéž bych byl mohl jít s ní .	ojalá yo hubiera podido ir con ella .
potřebuju sprchu .	necesito una ducha .
vypadáš zasmušile .	pareces triste .
ty tohle potřebuješ .	necesitas esto .
potřebuješ toto .	necesitas esto .
neměl jsem se včera učit .	no debí estudiar ayer .
slyšel jsem , jak někdo volá mé jméno .	escuché a alguien llamar mi nombre .
potřebuji pomoc .	necesito ayuda .
ona je alkoholička .	ella es alcohólica .
minulost lze jen znát , ne změnit . budoucnost lze jen změnit , ne znát .	el pasado sólo puede conocerse , no cambiarse . el futuro sólo puede cambiarse , no conocerse .
autobus ještě nepřijel .	el autobús todavía no ha llegado .
ruce sis stále ještě neumyl , že ?	no te has lavado las manos todavía , ¿ verdad ?
ještě sis ruce neumyl , že ?	no te has lavado las manos todavía , ¿ verdad ?
měl jsem přijít dřív .	debí haber llegado más temprano .
dosud závisí na svých rodičích .	ella depende todavía de sus padres .
i když neuspějeme na první pokus , můžeme šukat dál , než otěhotním .	aun si no tenemos suerte en el primer intento , podemos seguir cogiendo hasta que yo quede embarazada .
tu loď stále lze vidět .	el barco todavía se puede ver .
ještě jsem dnešní noviny nečetl .	todavía no he leído el periódico de hoy .
vůbec nemám hlad .	no tengo hambre en absoluto .
proč to děláš ?	¿ por qué haces eso ?
kde se narodil a kde vyrostl ?	¿ dónde nació él , y dónde creció ?
nabídka zaměstnání je nadále platná .	la oferta de trabajo es todavía válida .
pamatuj , že musíš umřít .	recuerda que debes morir .
nejdřív bych měl vyslechnout obě strany .	primero , debería escuchar ambas partes .
nemusíš mi volat .	no necesitas llamarme .
volat mi nemusíš .	no necesitas llamarme .
nemusíš mi telefonovat .	no necesitas telefonearme .
telefonovat mi nemusíš .	no necesitas telefonearme .
on to ještě neví , ale už je mrtvý .	él todavía no lo sabe , pero ya está muerto .
kolik času potřebujeme dostat se tam autobusem ?	¿ cuánto tiempo necesitamos para viajar allá en autobús ?
už ho nepotřebuju .	ya no lo necesito .
už to nepotřebuju .	ya no lo necesito .
potřebuješ tuhle knihu ?	¿ necesitas este libro ?
můj sen je nadále jen snem .	mi sueño es todavía solo un sueño .
john pozorně poslouchal .	john escuchó atentamente .
určitě měli nehodu .	deben haber tenido un accidente .
poslouchejte tuto hudbu a uvolněte se .	escuche esta música y relájese .
měli jsme být opatrnější .	deberíamos haber tenido más cuidado .
měli jsme být pozornější .	deberíamos haber estado más atentos .
měli jsme dávat větší pozor .	deberíamos haber prestado más atención .
povedlo se mi stihnout poslední vlak .	he conseguido coger el último tren .
obsluhovala nás hezká servírka .	nos atendió una mesera bonita .
někdo zaklepal na dveře .	alguien tocó a la puerta .
kdybych se znovu narodil , chtěl bych být ptákem .	si yo renaciera , quisiera ser un pájaro .
nechtěl jsem tě znepokojit .	no quise alarmarte .
přesně to jsem potřeboval .	yo necesitaba exactamente eso .
kéž bych byl mladší .	ojalá yo fuera más joven .
ještě jsem to neudělal .	todavía no lo hice .
určitě vstoupil do této místnosti .	él debe haber entrado a esta habitación .
určitě mu ujel vlak .	él debe haber perdido el tren .
jeho vystupování je obdivuhodné .	su comportamiento es admirable .
je divné , že poštovní doručovatel ještě nepřišel .	extraño que no haya venido el cartero todavía .
jsi-li po mém boku , nic víc nepotřebuju .	si estás a mi lado no necesito nada más .
jak se jmenuje tento pták ?	¿ cómo se llama este pájaro ?
kéž bych byla mladší .	ojalá fuera más joven .
kéž by byla mladší .	ojalá fuera más joven .
je mu rok a pět měsíců , ale chodit stále neumí .	tiene un año y cinco meses , pero todavía no puede andar .
kdo je tam ?	¿ quién está ahí ?
dosud jsem nebyl schopen najít zaměstnání .	todavía no he podido encontrar un trabajo .
učitel mu dovolil jít domů .	el profesor le permitió ir a casa .
jaké plány máš na víkend ?	¿ qué planes tienes para el fin de semana ?
celé město bylo bez elektřiny .	la ciudad entera quedó sin electricidad .
cizí člověk je přítel , kterého jsi prostě dosud nepoznal .	un extraño es un amigo que simplemente no has conocido todavía .
na učení se cizím jazykům je nutno mít mnoho trpělivosti .	hay que tener mucha paciencia para aprender lenguas extranjeras .
mám velký hlad ; kde můžu najít něco k snědku ?	tengo mucha hambre ; ¿ dónde puedo encontrar algo para comer ?
jsem trošku opilý .	estoy un poquito borracho .
můj otec ještě domů nedorazil .	mi padre todavía no ha llegado a casa .
přibral jsi , že ?	has cogido peso , ¿ verdad ?
přibralas , že ?	has cogido peso , ¿ verdad ?
kéž bys o mně přestal pochybovat .	ojalá dejases de dudar de mí .
všechny rostliny potřebujou vodu a světlo .	toda planta necesita agua y luz .
jsi s nimi stále ve styku ?	¿ todavía te pones en contacto con ellos ?
je ryba stále naživu ?	¿ el pez está vivo todavía ?
neměl jsi sníst tolik zmrzliny .	no debiste haber comido tanto helado .
budeš potřebovat mnohem víc peněz , než potřebuješ teď .	necesitarás mucho más dinero de lo que necesitas ahora .
strč prst skrz krk !	¡ introduce el dedo a través de la garganta !
dosud nepřišel . možná se mu něco přihodilo .	todavía no ha venido . puede que le haya pasado algo .
ztratil jsem brýle , ale bez nich je nenajdu .	he perdido mis gafas , pero las necesito para encontrarlas .
týden má sedm dní .	una semana tiene siete días .
obchod zůstává otevřen celý den .	la tienda permanece abierta todo el día .
pršelo ještě vydatněji .	la lluvia caía con más fuerza todavía .
možná mu ujel jeho obvyklý autobus .	quizá haya perdido el autobús que suele coger .
muž , který napsal tuto knihu , je lékař .	el hombre que escribió este libro es un doctor .
kéž bych se byl zamlada víc učil .	ojalá yo hubiera estudiado más cuando era joven .
prosím tě , řekni mi pravdu .	por favor dime la verdad .
abys v životě uspěl , potřebuješ dvě věci : neznalost a sebevědomí .	para triunfar en la vida necesitas dos cosas : ignorancia y confianza .
je lehké si najít přátele , ale je těžké se jich zbavit .	hacer amigos es fácil , pero es difícil deshacerse de ellos .
je v bryndě , protože viděla , co vidět neměla .	ella está en problemas porque vio algo que no debería haber visto .
má potíže , protože viděla něco , co neměla vidět .	ella está en problemas porque vio algo que no debería haber visto .
chytili jsme zloděje .	cogimos al ladrón .
náš tým je stále neporažený .	nuestro equipo todavía está invicto .
dosud mě bolí záda .	la espalda todavía me duele .
ještě to nevidíme .	todavía no podemos verlo .
kéž bys byla mohla jít s námi .	ojalá pudieras venir con nosotros .
kéž bys byl mohl jít s námi .	ojalá pudieras venir con nosotros .
měl jsem se ohledně této záležitosti poradit se svými rodiči .	debí haber consultado a mis padres sobre este asunto .
potřebuju se vysprchovat .	necesito ducharme .
raději bych šel pěšky , než jet autobusem .	preferiría caminar a coger el autobús .
jak se jmenujete ?	¿ cómo se llama usted ?
jak se jmenuje tamto zvíře ?	¿ cómo se llama ese animal ?
proč potřebuješ nový žebřík ?	¿ por qué necesitas una escalera nueva ?
proč potřebujete nový televizor ?	¿ por qué necesita usted un televisor nuevo ?
proč potřebujete nový deštník ?	¿ por qué necesita un paraguas nuevo ?
potřebuješ vstupenku .	necesitas una entrada .
potřebuješ klíče ?	¿ necesitas las llaves ?
přibral jsi .	has cogido peso .
pak můžu ještě dalších pět minut spát .	entonces todavía puedo dormir cinco minutos más .
měls to udělat .	deberías haberlo hecho .
tady se nedá dýchat .	aquí no se puede respirar .
jak mě uviděli , hned přestali mluvit .	al verme , repentinamente dejaron de hablar .
kéž bych byl poslechl lékařovu radu .	ojalá hubiera seguido el consejo del doctor .
kéž bych se byl řídil radou lékaře .	ojalá hubiera seguido el consejo del doctor .
měl jsem se té přednášky zúčastnit .	debí haber asistido a la conferencia .
miminko otevřelo pusu .	el bebé abrió la boca .
dítě potřebuje svou matku .	el bebé necesita a su madre .
není mi smutno .	no me siento triste .
zaklepal na dveře .	él tocó la puerta .
chci masáž . potřebuji se uvolnit .	quiero un masaje . necesito relajarme .
škola potřebovala nového učitele .	la escuela necesitaba un nuevo maestro .
kéž by si mě vzal .	¡ ojalá se casara conmigo !
kéž by si mě vzala .	¡ ojalá se casara conmigo !
takto se lidé zbavují věcí , které už nepotřebují .	así es como la gente se libra de las cosas que ya no necesitan .
kéž bych byl bohatý .	ojalá fuera rico .
kéž bych byla bohatá .	ojalá fuera rica .
mormoni zakázali polygamii , ale někteří z nich ji dosud provozují .	los mormones han prohibido la poligamia pero algunos de ellos todavía la practican .
dosud se mi neozvala .	todavía no sé nada de ella .
už mě hlava nebolí .	ya no me duele la cabeza .
onen dům patří jemu .	esa casa le pertenece a él .
přestože tady sedím na slunci , stále je mi zima .	a pesar de estar sentado aquí al sol , todavía tengo frío .
jsem šťastný jako blecha .	soy tan feliz como una lombriz .
umyj mi záda , prosím .	por favor , lávame la espalda .
znám ji už dávno .	la conozco desde hace mucho tiempo .
vyčisti zrcadlo .	limpia el espejo .
kéž by nám pomohl náš otec .	ojalá nos ayudara nuestro padre .
kéž by v mém zaměstnání bylo více rozmanitosti .	ojalá hubiera más variedad en mi trabajo .
kéž by má práce byla pestřejší .	ojalá hubiera más variedad en mi trabajo .
kéž bys přišel na můj večírek .	ojalá vinieras a mi fiesta .
měla být opatrnější .	ella debió haber tenido más cuidado .
fyziku mám rád , a matematiku ještě víc .	me gusta la física , y las matemáticas me gustan aún más .
teď nepotřebuju nic .	no necesito nada ahora .
to je jeden z důvodů , proč už to znovu neudělám .	esa es una de las razones por las que no lo volveré a hacer .
kdybys býval přišel o trochu dříve , býval by ses s ní mohl seznámit .	si hubieras venido un poco antes , hubieras podido conocerla .
málo močím .	orino poco .
musím se učit .	necesito estudiar .
řekni mi , v kolik přijdeš .	dime a qué hora vendrás .
nikdo nám nechtěl pomoci .	nadie quiso ayudarnos .
nikdy se mi nelíbila a nikdy se mi líbit nebude .	ella nunca me ha gustado y nunca me gustará .
kéž by mě napadlo , co říct .	ojalá pudiera pensar en algo que decir .
nemáš žízeň ?	¿ no tienes sed ?
je hezká .	es guapa .
popravdě řečeno , nejsem tvůj otec .	a decir verdad , yo no soy tu padre .
abych byl upřímný , nejsem tvůj otec .	para ser sincero , yo no soy tu padre .
potřebuju novou propisku . nějakou koupím .	necesito un nuevo bolígrafo . compraré uno .
můj otec půjde na operaci .	mi padre va a ser operado .
nikdy se neobrací zády k příteli , který potřebuje pomoc .	él nunca da la espalda a un amigo que necesita ayuda .
líbilo se ti ?	¿ te gustó eso ?
začínám dnes odpoledne .	empiezo esta tarde .
řekni mi , kdy začít .	dime cuándo empezar .
nemůžu s tebou souhlasit .	no puedo estar de acuerdo contigo .
potřebuju , aby mě někdo obejmul a řekl mi , že všechno bude v pořádku .	necesito que alguien me abrace y que me diga que todo estará bien .
vem knihu a čti !	¡ coge un libro y lee !
potřebuje ho .	él lo necesita .
on to potřebuje .	él lo necesita .
když jsi rodičem , je důležité být svým dětem dobrým příkladem .	cuando eres padre , es importante ser un buen ejemplo para tus hijos .
kéž by to byla pravda !	¡ ojalá fuera cierto !
co víc bys sis přál !	¡ qué más quisieras !
z této zprávy posmutněla .	esta noticia la puso triste .
tato zpráva ji zarmoutila .	esta noticia la puso triste .
potřebuji tvůj pas a tři fotografie .	necesito tu pasaporte y tres fotos .
můžu tady fotit ?	¿ puedo hacer fotos aquí ?
vstaň co nejdřív .	levántate tan pronto como puedas .
šli jsme se projít do lesa .	nos dimos un paseo por el bosque .
potřebuješ stále ještě čaj ?	¿ todavía necesitas té ?
mám vejce .	tengo un huevo .
mám vajíčko .	tengo un huevo .
maďarský jazyk je lepší než esperanto .	la lengua húngara es mejor que el esperanto .
neplakala , zdála se být lhostejná , ale já vím , že byla smutná .	ella no lloró , ella parecía indiferente , pero sé que estaba triste .
chybí stránka .	falta una página .
nemá ráda nikoho a nikdo ji .	a ella no le gusta nadie y ella no le gusta a nadie .
kéž by přišel .	ojalá venga .
kéž by přišla .	ojalá venga .
báli se učitele .	tenían miedo del maestro .
bály se učitele .	tenían miedo del maestro .
potřebuju kravatu ?	¿ necesito una corbata ?
mám velký hlad .	tengo mucha hambre .
řekni mi , kdy přestat .	dime cuándo parar .
kéž bych se byl zamlada učil anglicky pilněji .	ojalá hubiera estudiado inglés más duro cuando fui joven .
kéž bych byl včera večer šel do divadla .	ojalá hubiera ido al teatro la noche anterior .
kéž bych byl do divadla šel včera večer .	ojalá hubiera ido al teatro la noche anterior .
potřebuju trochu cukru .	necesito algo de azúcar .
nepiju .	no bebo alcohol .
dvě a dvě jsou čtyři .	dos más dos son cuatro .
já jsem vdaná , ty jsi ženatý , vezměme se !	yo soy casada , vos sos casado , ¡ casémonos !
kolibřík je nejmenší pták světa .	el colibrí es el ave más pequeña del mundo .
neviděl jsem nikoho .	no vi a nadie .
nikoho jsem neviděl .	no vi a nadie .
neviděla jsem nikoho .	no vi a nadie .
nikoho jsem neviděla .	no vi a nadie .
najednou se černý králíček posadil a vypadal velice smutně .	de pronto el pequeño conejo negro se sentó , y se veía muy triste .
už není sama .	ya no está sola .
napsala knihu o zvířatech .	ella escribió un libro sobre animales .
potřebuje pro svůj hněv produktivnější ventil .	él necesita una salida más productiva para su furia .
tohle je vše , co potřebuji vědět .	esto es todo lo que necesito saber .
pochybuji , že by byl advokátem .	dudo que sea abogado .
nemůžu na tebe čekat .	no puedo esperarte .
není potřeba se omlouvat .	no hay necesidad de disculparse .
potřebuju srát .	necesito cagar .
znám dívku , která se věčně usmívá .	conozco una chica que está siempre sonriendo .
rád dekoruji svůj byt dle svého gusta .	me gusta decorar mi apartamento a mi gusto .
lidi se mu obvykle smáli za zády .	la gente solía reírse de él a sus espaldas .
potřebuješ ještě něco ?	¿ necesitas algo más ?
kolikrát v týdnu se koupeš ?	¿ cuántas veces te bañas a la semana ?
kolik dní v týdnu chodíš do školy ?	¿ cuántos días a la semana vas a la escuela ?
vzal si týdenní volno .	se tomó la semana libre .
řeknete mi , jak se jmenujete .	dígame cómo se llama .
zdůraznil potřebu neprodleného konání .	él enfatizó la necesidad de una acción inmediata .
kladl důraz na nezbytnost okamžité akce .	él enfatizó la necesidad de una acción inmediata .
nejez jako prase .	no comas como cerdo .
přestala trhat kopretiny .	dejó de coger margaritas .
kéž bys mi byl řekl pravdu .	ojalá me hubieras dicho la verdad .
kdybys mi jen byl řekl pravdu .	ojalá me hubieras dicho la verdad .
nechyběl žádný student .	no faltaba ningún estudiante .
přál bych si nějaké boty .	quisiera unos zapatos .
není strach bez naděje , ani naděje beze strachu .	no hay miedo sin esperanza , ni esperanza sin miedo .
nemusí pracovat .	él no necesita trabajar .
dveře zůstávají zavřené .	la puerta permanece cerrada .
tady chybí ubrousek .	aquí falta una servilleta .
kéž by mohl přijít ! moc ráda bych ho viděla .	¡ ojalá pueda venir ! me encantaría verle .
ten psací stůl se do této místnosti nevejde .	ese escritorio no cabe en esta habitación .
nezapomeň si vzít deštník , až budeš odcházet .	no te olvides de coger el paraguas cuando salgas .
kéž bych se byl řídil tvou radou .	ojalá hubiera seguido tu consejo .
řekla tak s usměvem .	lo dijo con una sonrisa .
je to tvoje ?	¿ es tuyo ?
kéž by metro nebylo každé ráno tak plné .	ojalá el metro no estuviera tan lleno todas las mañanas .
co ho tak zarmoutilo ?	¿ qué le ha puesto tan triste ?
mohu mu pomoci , potřebuje-li to .	puedo ayudarle si lo necesita .
většina lidí má ráda léto , ale já osobně mám mnohem raději zimu .	a la mayoría de la gente le gusta el verano , pero a mí , me gusta mucho más el invierno .
mám hlad , protože jsem neobědval .	tengo hambre porque no he almorzado .
mám hlad , protože jsem neobědvala .	tengo hambre porque no he almorzado .
měla tu práci dokončit včera .	ella debía terminar ese trabajo ayer .
potřebuju nůž .	necesito un cuchillo .
nemám hlad .	no tengo hambre .
hlad nemám .	no tengo hambre .
potřebuji následující .	necesito lo siguiente .
potřebuješ se učit pilněji .	necesitas estudiar más duro .
musíš ke svým rodičům být uctivý .	debes ser respetuoso con tus padres .
proto jsem smutný .	estoy triste por eso .
už dávno jsem ho neviděl .	hace mucho tiempo que no lo veo .
tvářila se smutně .	ella puso una expresión triste .
tři osoby ještě chybí .	todavía faltan tres personas .
nechci svým rodičům být další přítěží .	no quiero ser una carga más para mis padres .
když prší , jezdí autobusem .	cuando llueve , ella coge el autobús .
potřebuji lžíci , vidličku a nůž . děkuji .	necesito una cuchara , un tenedor y un cuchillo . gracias .
potřebuji , abys mi pomohl .	necesito que me ayudes .
potřebuji , abys mi pomohla .	necesito que me ayudes .
ten obchod prodává široký sortiment výrobků .	esa tienda vende una gran variedad de productos .
nevěděli jsme , kterým autobusem jet .	no sabíamos qué autobús coger .
na světě jsou tři různé druhy lidí : ti , kteří dovedou počítat , a ti , kteří to nedovedou .	hay tres tipos de personas diferentes en el mundo : aquellos que saben contar y aquellos que no saben .
potřebuji mnoho knih .	necesito muchos libros .
potřebuji další polštář .	necesito otra almohada .
jak se jmenuje tamhleta řeka ?	¿ cómo se llama aquel río ?
učím se česky .	estoy aprendiendo checo .
nic jsem nevěděl .	no sabía nada .
tamten dům patří mně .	aquella casa me pertenece .
zeptal jsem se ho , jak se jmenuje .	le pregunté cómo se llamaba .
dala mu peníze , které mu dlužila .	ella le dio el dinero que le debía .
nebylo nutné , aby běžel tak rychle .	no fue necesario que corriera tan rápido .
nebylo zapotřebí , aby běžel tak rychle .	no fue necesario que corriera tan rápido .
atom se skládá z protonů , neutronů a elektronů .	un átomo está formado por protones , neutrones y electrones .
netřeba říkat , že nikdy znovu nepřišel .	no hay necesidad de decir que él nunca vino de nuevo .
půjčím si pero .	te cojo prestado un boli .
to budete mít nejlepší .	será lo mejor .
ukažte mi to na mapě .	muéstramelo en el plano .
fakt to za to stojí .	realmente vale la pena .
to je určitě tomův bratr .	debe de ser el hermano de tom .
zavolej mi , když budeš potřebovat pomoc .	llámame si necesitas ayuda .
měl jsem ty peníze vzít .	debí haber tomado el dinero .
rád bych aspirin .	quisiera una aspirina .
potřeboval jen čas na dokončení svého obrazu .	sólo necesitaba tiempo para acabar su cuadro .
měls mi říct pravdu .	deberías haberme contado la verdad .
politikům se nedá věřit .	no se puede confiar en los políticos .
bolí mě záda .	me duele la espalda .
jak dlouho potřebuje veterinář na vyšetření koně ?	¿ cuánto tiempo necesita un veterinario para examinar a un caballo ?
kéž bys tolik nekouřil .	ojalá no fumaras tanto .
jak se jmenuje vaše dcera ?	¿ cómo se llama su hija ?
jak se jmenuje jeho dcera ?	¿ cómo se llama su hija ?
jak se jmenuje její dcera ?	¿ cómo se llama su hija ?
jak se jmenuje jejich dcera ?	¿ cómo se llama su hija ?
není žádný důvod , proč bys to neměl dělat .	no hay ninguna razón por la que no debas hacerlo .
kdybych byl letěl tím letadlem , byl bych teď mrtvý .	si hubiera cogido ese avión , ahora estaría muerto .
včera bylo zemětřesení .	hubo un terremoto ayer .
bolí vědět , že ji má nepřítomnost těší .	duele saber que mi ausencia la hace feliz .
myslel , že jsem velmi unavený .	él pensó que yo estaba muy cansado .
nemůže pít alkohol .	no puede beber alcohol .
má víc peněz , než potřebuje .	tiene más dinero de lo que necesita .
ten smutný příběh nás rozplakal .	la triste historia nos hizo llorar .
zamlada určitě byla velmi krásná .	ella debió ser muy bella de joven .
do zítřejšího rána musíme učinit rozhodnutí .	antes de mañana por la mañana debemos de tomar una decisión .
když teď jsi dospělý , nesmíš se chovat jako dítě .	ahora que eres mayor , no te debes comportar como un niño .
k ušití dlouhých šatů je třeba hodně látky .	para hacer un vestido largo , se necesita mucha tela .
vždy jsem se s tebou chtěl seznámit .	siempre he querido conocerte .
vždy jsem se s tebou chtěla seznámit .	siempre he querido conocerte .
vždy jsem se s tebou chtěla setkat .	siempre he querido conocerte .
vždy jsem se s tebou chtěl setkat .	siempre he querido conocerte .
nebylo třeba volat taxík .	no había necesidad de llamar a un taxi .
krabice je ze dřeva .	la caja es de madera .
nevím , jestli se smát nebo plakat .	no sé si reír o llorar .
na jídelním lístku byl široký výběr pokrmů .	había una gran variedad de platos en el menú .
potřebuju něco k snědku .	necesito algo para comer .
kolik je na světě jazyků ?	¿ cuántos idiomas hay en el mundo ?
měls poslouchat pozorněji .	debería haber escuchado con más atención .
země je schopna uspokojit naše potřeby , ne ale naši chamtivost .	la tierra puede satisfacer nuestras necesidades , pero no nuestra avaricia .
přinesl nám smutné zprávy .	él nos trajo noticias tristes .
je zapotřebí hodně vody .	se necesita mucha agua .
jak se píše tvoje příjmení ?	¿ cómo se escribe tu apellido ?
tento most je ze železa .	este puente es de hierro .
mám hlad , takže půjdu najít něco k jídlu .	tengo hambre , así que voy a buscar algo para comer .
je smutné nebýt milován , ale mnohem smutnější nebýt schopen milovat .	es triste no ser amado , pero es mucho más triste no ser capaz de amar .
kočky nepotřebujou obojky .	los gatos no necesitan collares .
pochybuji , že to funguje .	dudo que eso funcione .
kéž bych byl poslechl tvou radu .	ojalá hubiera escuchado tu consejo .
pak jsme si podali ruku a řekli si sbohem .	entonces nos dimos la mano y nos dijimos adiós .
zrovna jsem dojedl , takže nemám hlad .	me he acabado de comer , así que no tengo hambre .
zrovna jsem dojedla , takže nemám hlad .	me he acabado de comer , así que no tengo hambre .
právě jsem dojedl , takže hlad nemám .	me he acabado de comer , así que no tengo hambre .
právě jsem dojedla , takže hlad nemám .	me he acabado de comer , así que no tengo hambre .
napsal knihu , když byl v číně .	él escribió un libro cuando estaba en china .
mám takový hlad , že bych snědl koně .	tengo tanta hambre que me comería un caballo .
tahle noc patří světluškám a netopýrům . . . a vlkodlakům .	esta noche pertenece a las luciérnagas y a los murciélagos . . . y a los hombres lobo .
někteří z nich spáchali sebevraždu .	algunos de ellos se han suicidado .
kéž by brzy zapršelo !	¡ ojalá llueva pronto !
zlato je v oběhu , protože má hodnotu , kdežto papírová měna má hodnotu , protože je v oběhu .	el oro circula porque tiene valor , pero el papel moneda tiene valor porque circula .
řekni mi jasně , jaké máš záměry .	dime claramente cuáles son tus intenciones .
kéž bych dovedl plavat .	ojalá pudiera nadar .
kéž bych uměl plavat .	ojalá supiera nadar .
chtěl bych umět plavat .	desearía poder nadar .
měl bys ses naučit používat svůj slovník .	deberías aprender a usar tu diccionario .
helena zesmutněla , vidouc , že jsme nepřinesli žádný dárek .	helena se puso triste al ver que no traíamos ningún regalo .
potřebovala někoho , kdo by jí rozuměl .	ella necesitaba a alguien que la comprendiera .
v kanadě je zakázano požívat alkohol mladistvým do dvaceti let .	en canadá no se les permite beber alcohol a los menores de veinte años .
dovedeš rozeznat kozu od ovce ?	¿ puedes distinguir una cabra de un carnero ?
stále ještě se chová jako dítě .	ella todavía se comporta como un niño .
kéž bych to byl věděl !	¡ ojalá lo hubiera sabido !
kéž bych byl po tvém boku !	¡ ojalá estuviera a tu lado !
kéž by přišel !	¡ ojalá él viniera !
musím jít , přestože se mi nechce .	tengo que ir , a pesar de que no tengo ganas .
měli jsme mu říct pravdu .	deberíamos haberle contado la verdad .
dej to komukoliv , kdo to bude potřebovat .	dáselo a alguien que lo necesite .
co byste udělal na mém místě ?	¿ qué haría usted en mi lugar ?
co byste udělala na mém místě ?	¿ qué haría usted en mi lugar ?
ne , teď zrovna odcházet nemusíš .	no , no necesitas irte ahora mismo .
kéž bys mi byla nablízku .	ojalá estuvieras cerca de mí .
alice utíká , aby stihla autobus .	alice está corriendo para coger el autobús .
myslím , že ta polévka potřebuje trošku osolit .	creo que la sopa necesita un poco de sal .
nalezla potřebu a uspokojila ji .	ella encontró una necesidad y la satisfizo .
vezmi žebřík a vyměň žárovku .	coge la escalera y cambia la bombilla .
měls to vidět !	¡ deberías haberlo visto !
potřebuju víc zlata .	necesito más oro .
vypadá smutně .	ella se ve triste .
příliš nesouhlasím s jeho nápadem , ale bohužel nemám lepší .	no estoy muy de acuerdo con su idea , pero por desgracia no tengo ninguna mejor .
potřebujeme oheň .	necesitamos fuego .
potřebujeme více zaměstnanců .	necesitamos más empleados .
kdybych jen věděl , kde je !	¡ ojalá supiera dónde está !
ta kniha je nová .	el libro es nuevo .
zabloudili jsme v lese .	nos hemos perdido en el bosque .
to je dobrá otázka .	esta es una buena pregunta .
zapomněl jsem , jak se jmenuje .	he olvidado cómo se llama .
zapomněla jsem , jak se jmenujete .	he olvidado cómo se llama .
na počátku stvořil bůh nebe a zemi .	al principio dios creó el cielo y la tierra .
kdo umí , umí !	¡ el que sabe , sabe !
hořčík je chemický prvek .	el magnesio es un elemento químico .
už ho nepotřebuju .	ya no le necesito .
tys zabil mého otce .	tú mataste a mi padre .
zachránil jsi mi život .	me salvaste la vida .
dáme si páku ?	¿ echamos un pulso ?
ahoj krasavče !	¡ hola guapo !
mám turistické víza .	tengo un visado de turista .
vy jste rasista .	usted es racista .
necítím žádnou potřebu stýkat se s ostatními .	no siento ninguna necesidad de relacionarme con los demás .
kéž by mi rozuměl !	¡ ojalá me entienda !
kéž by bylo víc lidí jako ty .	ojalá hubiera más gente como tú .
dávám si pivo .	estoy tomándome una cerveza .
mary toma nezajímá .	a tom no le interesa mary .
to tě činí ještě přitažlivější .	eso te hace aún más atractiva .
šel jsem na pivo s přáteli .	fui a tomar una cerveza con mis amigos .
nebudete-li plnit své sliby , lidé vás nebudou brát vážně .	si usted no cumple sus promesas , la gente no lo tomará en serio .
vždy bys měl zaklepat na dveře , než vejdeš do tomova pokoje .	siempre deberías golpear la puerta antes de entrar a la habitación de tom .
bez kyslíku by všechna zvířata dávno zmizela .	sin oxígeno , todos los animales habrían desaparecido hace mucho tiempo .
byly to nejsmutnější hodiny mého života .	esas fueron las horas más tristes de mi vida .
zaklepala na dveře .	ella tocó la puerta .
kéž bych znal jeho adresu .	ojalá conociera su dirección .
mně se alkohol hnusí .	a mí el alcohol me repele .
na napsání této knihy jsem potřeboval tři roky .	he necesitado tres años para escribir este libro .
tom moc nepije .	tom no toma mucho .
jak se jmenuje tvůj přítel ?	¿ cómo se llama tu amigo ?
on ale potřeboval práci .	pero él necesitaba trabajo .
jediné , co teď tom potřebuje , je trocha trpělivosti .	lo único que tom necesita ahora es un poco de paciencia .
je jednodušší zavést v evropě společnou měnu než společný jazyk .	es más fácil introducir en europa una moneda común que una lengua común .
chci vědět , jestli víš , kdo ho zabil .	quiero saber si tú sabes quién le mató .
chci vědět všechno , co víš ty .	quiero saber todo lo que sabes tú .
neviděl jsem nikoho kromě tebe .	no vi a nadie aparte de ti .
vždy mě pomlouvají za zády .	siempre hablan mal de mí a mis espaldas .
umění není přepych , ale potřeba .	el arte no es un lujo , sino una necesidad .
já jsem žena .	yo soy una mujer .
šel jsem tam z nutnosti .	fui allí por necesidad .
je to jen malý dům , ale mým potřebám vyhovuje dokonale .	es sólo una casa pequeña pero se ajusta perfectamente a mis necesidades .
mám hlad ! pojďme se navečeřet , prosím !	¡ tengo hambre ! ¡ vamos a cenar por favor !
potřebujeme víc kávy .	necesitamos más café .
jakkoli byla smutná , sbohem mu dala s úsměvem .	triste como estaba , le dijo adiós con una sonrisa .
nepotřebuju kázání .	no necesito un sermón .
je to jen hra .	es solo un juego .
běž , nebo přijdeš pozdě .	corre , o vas a llegar tarde .
někdo mi zachránil život .	alguien ha salvado mi vida .
proč jsi nás o tom neinformoval dříve ?	¿ por qué no nos has informado antes acerca de eso ?
kdo napsal ten dopis ?	¿ quién ha escrito la carta ?
vždy volá své matce v den jejích narozenin .	él siempre llama a su madre el día de su cumpleaños .
dovolte mi , abych to nahradil .	permítame reponerlo .
zhruba kolik anglických slov znáš ?	¿ como cuántas palabras conoces del inglés ?
možná se nejedná o jednoduchou nehodu ?	¿ acaso no se trata de un simple accidente ?
populace této země se postupně snižuje .	la población de este país disminuye poco a poco .
kterým směrem šel ?	¿ en qué dirección ha ido él ?
tom odešel před třemi dny .	tom partió tres días atrás .
na stole je dopis .	sobre el escritorio hay una carta .
nemám rád knihy o více než pěti stech stranách .	no me gustan los libros de más de quinientas páginas .
minulost nelze vymazat .	el pasado no se puede borrar .
s kým myslíš , že bydlí ?	¿ con quién crees que vive ella ?
existuje pět způsobů , jak se vymanit z pout tělesné touhy .	existen cinco maneras de emanciparse de las ataduras de los deseos carnales .
co si myslíš o japonštině ?	¿ qué opinas tú de la lengua japonesa ?
myslel , že jsem vyčerpaný .	él pensó que yo estaba exhausto .
když přestal běžet , byl spokojen .	cuando él dejó de correr , estaba satisfecho .
sleduj pozorně . předvedu ti , jak se to dělá .	observa con atención . te mostraré como uno hace eso .
můj milenec mě nemiluje .	mi amante no me ama .
raději bys v jeho přítomnosti neměl kouřit .	mejor no deberías fumar en su presencia .
dal mi kytici .	él me regaló un ramillete de flores .
mám pro tebe překvapení .	tengo una sorpresa para ti .
nenáviděla ho i po tom , co zemřel .	aun después de que él muriera , ella lo odiaba .
už dávno jsem tě neviděl se usmát .	hace mucho tiempo que no te veo sonreír .
lincoln souhlasil , že všichni otroci by měli být osvobozeni .	lincoln estaba de acuerdo en que todos los esclavos debían ser liberados .
pro hustou mlhu byla cesta špatně vidět .	a causa de la densa neblina , el camino era difícil de ver .
potřebuješ svézt ?	¿ necesitas que te lleven ?
kuře mi moc nechutná .	no me gusta mucho el pollo .
potřebuju čas a prostor .	necesito tiempo y espacio .
velryba náleží k savcům .	la ballena pertenece a los mamíferos .
tato košile potřebuje vyžehlit .	esta camisa necesita ser planchada .
dal mi , co jsem potřeboval .	él me dio lo que yo necesitaba .
je smutné , že musíš odejít .	es triste que te tengas que ir .
chybělo už jen to !	¡ sólo eso faltaba !
chybí mu peníze .	le falta dinero .
chybí jí peníze .	le falta dinero .
chybí mu zkušenosti , že ?	¿ le falta experiencia , no ?
teď zrovna hlad nemám .	ahora no tengo hambre .
mluvit tímtéž jazykem neznamená mít tentýž názor .	hablar la misma lengua no significa tener la misma opinión .
co chceš říct tím ' ' nelíbí se mi ' ' ?	¿ qué quieres decir con no me gusta ?
jako my potřebujeme čerstvý vzduch , ryby potřebujou čistou vodu .	tal como nosotros necesitamos aire fresco , los peces necesitan agua limpia .
děti potřebujou mnohé , ale především lásku .	los niños necesitan muchas cosas , pero antes que todo , ellos necesitan amor .
nepotřebuji tvé peníze . potřebuji jen tvůj čas .	yo no necesito tu dinero . solo necesito tu tiempo .
člověk musí splnit svou povinnost .	uno debe cumplir con su deber .
tvé vlasy září jako zlato !	sus cabellos brillan como el oro .
to tom říkat neměl .	tom no debería haber dicho eso .
tom neměl udělat , co udělal .	tom no debía haber hecho lo que él hizo .
tom to neměl udělat .	tom no debió haberlo hecho .
tom sem neměl chodit .	tom no debió haber venido aquí .
tom měl čekat na mary .	tom debía haber esperado a mary .
tom měl říct mary .	tom debió haberle dicho a mary .
tom měl víc studovat .	tom debió haber estudiado más .
tom si měl vzít mary .	tom debió haberse casado con mary .
tom měl vědět .	tom debía haber sabido .
tom si měl zatančit s mary .	tom debió haber bailado con mary .
tom měl zavolat .	tom debió haber llamado .
zeptal jsem se své profesorky , co mám udělat potom .	yo le pregunté a mi profesora que debía hacer a continuación .
není třeba , aby pracoval .	no hay necesidad para él de trabajar .
nemáš dobrou paměť .	tú no tienes una buena memoria .
je mi zapotřebí peněz .	me hace falta dinero .
železo je užitečnější než zlato .	el hierro es más útil que el oro .
utvořili kruh .	ellos se formaron en un círculo .
tom nikdy mary nebral vážně .	tom nunca tomó a mary en serio .
neřiď pod vlivem alkoholu .	no conduzcas bajo la influencia del alcohol .
kde jsem teď ?	¿ dónde estoy ahora ?
neměl jsem slov .	me faltaban palabras .
měls přijít předtím .	deberías haber venido antes .
zbývá jeden týden .	falta una semana .
nejedl jsem od snídaně , mám hlad .	no he comido desde el desayuno , tengo hambre .
od snídaně jsem nejedla , mám hlad .	no he comido desde el desayuno , tengo hambre .
neblbni , bez volantu se řídit nedá !	¡ no seas tonto , no se puede conducir sin volante !
teď mám velký hlad .	ahora tengo mucha hambre .
v kolik každý den vstáváš ?	¿ a qué hora te levantas todos los días ?
jím ovoce , protože mám hlad .	estoy comiendo frutas porque tengo hambre .
vždy jsem se s nimi chtěl seznámit .	siempre quise conocerlos .
vždy jsem se s vámi chtěl seznámit .	siempre quise conocerlos .
vždy jsem se s nimi chtěl setkat .	siempre quise conocerlos .
vždy jsem se s vámi chtěl setkat .	siempre quise conocerlos .
proč se chováš jako dítě ?	¿ por qué te comportas como un niño ?
očekávám , že mi pomůžete .	espero tu ayuda .
chtěla se rozvést .	ella quiso divorciarse .
jím , protože mám hlad .	como porque tengo hambre .
nemám psa , mám dva .	no tengo un perro , tengo dos .
není třeba jít .	no hace falta ir .
jeden plus dvě se rovná tři .	uno más dos es igual a tres .
sopečný popel porušil funkci letadla .	cenizas volcánicas trastornaron los viajes aéreos .
tvoje chování se mi nelíbí .	no me gusta tu comportamiento .
není třeba mluvit tak hlasitě .	no hay necesidad de hablar tan alto .
máš žízeň , chceš vodu ?	tenés sed , ¿ querés agua ?
alkohol nic nevyřeší , ale mléko taky ne .	el alcohol no soluciona nada , pero la leche tampoco .
řekni mi všechno .	dime todo .
pověz mi vše .	dime todo .
na počátku stvořil bůh nebe a zemi .	en el principio dios creó los cielos y la tierra .
když dva dělají totéž , není to totéž .	cuando dos personas hacen lo mismo , no es lo mismo .
vážně přemýšlíš , že budeš mít dítě ?	¿ estás pensando seriamente en tener un bebé ?
nejez tu meruňku !	¡ no te comas ese damasco !
návyk mění přepychové požitky v jednotvárné , každodenní potřeby .	el hábito convierte lujosos placeres en aburridas y cotidianas necesidades .
choval se jako blázen .	él se comportaba como loco .
ona proti alkoholu nic neměla .	ella no tenía nada contra el alcohol .
bude to překvapení !	¡ será una sorpresa !
vypil jsi tři šálky kávy .	has bebido tres tazas de café .
už tam někdy předtím byla ?	¿ ha estado ella allí antes ?
tos neměl dělat .	no deberías haberlo hecho .
jen lidské bytosti se dovedou smát .	sólo los seres humanos pueden reír .
on mě má rád , ale já jeho ne .	le gusto , pero él no me gusta .
život je plný překvapení .	la vida está llena de sorpresas .
nesmíš se přestat usmívat .	no puedes dejar de sonreír .
mám hlad jako vlk .	tengo un hambre canina .
z nějakého důvodu se mi od chvíle , co jsem se vrátil z indie , lidi vyhýbají jako moru .	por algún motivo , la gente me ha estado evadiendo como a la plaga desde el momento que volví de la india .
můj otec naléhal , že bychom měli jít .	mi padre insistió en que debíamos ir .
počítač je nyní naprostou nezbytností .	ahora un computador es una absoluta necesidad .
ve spojených státech je automobil nezbytností , a ne přepychem .	en los estados unidos , el automóvil es una necesidad y no un lujo .
z nutnosti řekla nevinnou lež .	ella dijo una mentira blanca por necesidad .
viděla ho usmívat se .	ella lo vio sonreír .
to je vskutku smutné .	eso es verdaderamente triste .
víme , kdo jsme , ale nevíme , kým být můžeme .	sabemos quiénes somos , pero no sabemos quiénes podemos ser .
jak se jmenuje tvoje nevlastní matka ?	¿ cómo se llama tu madrastra ?
něco se jí muselo stát .	algo debió haberle pasado a ella .
mary ještě nezačala .	mary todavía no ha empezado .
vysvětlili ti už , z jakých důvodů jsme s tebou neuzavřeli smlouvu ?	¿ ya te han explicado las razones de por qué no te contratamos ?
naše sny se splnily .	nuestros sueños se hicieron realidad .
nic na světě není tak dobře rozděleno jako intelekt : všichni si myslí , že ho mají dostatek .	nada en el mundo está tan bien repartido como el intelecto : todos piensan que tienen suficiente .
zapomněl jsem , že ti dlužím peníze .	olvidé que te debía dinero .
budeš-li se chovat jako debil , bude k tobě jako takovému přistupováno .	si te comportas como un imbécil , serás tratado como uno de ellos .
ethanol je alkohol .	el etanol es un alcohol .
kovářova kobyla chodí bosa .	en casa de herrero , cuchillo de palo .
lež má krátké nohy .	las mentiras tienen las patas muy cortas .
nejedná se o přání , jedná se o nezbytnost .	no se trata de voluntad , se trata de una necesidad .
věděl jsem , že to nemám dělat , ale stejně jsem to udělal .	sabía que no debí haberlo hecho , pero lo hice de todas formas .
zkusím to znovu , díky .	volveré a intentarlo , gracias .
někdo klepal na dveře .	alguien llamó a la puerta .
neboj se , ta nemoc není nakažlivá .	no tengas miedo , esa enfermedad no es contagiosa .
tvoje matka určitě zamlada byla krásná .	tu madre debe haber sido hermosa cuando joven .
dál se usmívej .	sigue sonriendo .
znovu budeš otcem !	¡ vas a ser padre de nuevo !
bude otcem podruhé .	él va a ser padre por segunda vez .
to nemá hlavu ani patu .	eso no tiene ni pies ni cabeza .
plavu rád , ale ne tady .	me gusta nadar , pero no me gusta nadar aquí .
chtěl bych , abys řídil .	quisiera que conduzcas .
rád bych , abys řídila .	quisiera que conduzcas .
mráz kopřivu nespálí .	mala hierba nunca muere .
nechme to plavat !	¡ borrón y cuenta nueva !
na koho čekáš ?	¿ a quién estás esperando ?
nevěda co udělat , požádal jsem ho o radu .	al no saber qué debía hacer , le pedí consejo .
nemluv , když nemáš co říct .	no hables cuando no tengas nada que decir .
naléhavě potřebujeme vodu .	tenemos una necesidad urgente de agua .
máme naléhavou potřebu vody .	tenemos una necesidad urgente de agua .
neměl jsem tě požádat , abys to udělal .	no debí haberte pedido que hicieras eso .
neměl jsem to udělat .	no debí haber hecho eso .
to jsem udělat neměl . je mi to líto .	no debí haber hecho eso . lo siento .
neměl jsem vypít tu poslední flašku piva .	no debí haberme tomado esa última botella de cerveza .
neměla jsem vypít tu poslední láhev piva .	no debí haberme tomado esa última botella de cerveza .
neměl jsem to jíst . je mi špatně .	no debí haber comido eso . me siento enfermo .
neměl jsem se do toho plést .	yo debería haber quedado fuera de eso .
rád bych si s tebou promluvil .	quisiera conversar contigo .
nemohu nebýt smutný , když se podívám na tuto fotografii .	no puedo evitar sentir triste al mirar a esta foto .
včera byl čtvrtek .	ayer fue jueves .
schází mi praxe .	me falta práctica .
můj otec neřídí , protože se bojí , že by utrpěl nehodu .	mi padre no conduce porque tiene miedo de sufrir un accidente .
mám trošku hlad .	tengo un poquito de hambre .
mám dost hlad , protože jsem nic nesnědl od časného rána .	tengo bastante hambre porque no he comido desde esta mañana temprano .
železo a kyslík jsou prvky .	el hierro y el oxígeno son elementos .
měl jsem odejít dřív .	debería haberme ido antes .
nebylo třeba mu to říci .	no hizo falta decírselo .
nebylo zapotřebí jí to říct .	no hizo falta decírselo .
nebylo nutné jim to povídat .	no hizo falta decírselo .
víte , co je tohle ?	¿ saben qué es esto ?
tom hodně pije .	tom toma mucho .
víš , co to je ?	¿ sabes qué es ?
dal bych si kávu .	quisiera tomar café .
ti , kteří jít nechtějí , jít nemusí .	aquellos que no deseen ir no tienen que ir .
jak se říká tomuto ?	¿ cómo se llama esto ?
jak se jmenuje tohle ?	¿ cómo se llama esto ?
ona ho potřebuje víc , než on ji .	ella le necesita más de lo que él la necesita .
vysvětli , jaké přesně jsou důvody .	explica cuáles son exactamente las razones .
mary se tomovi nelíbila a on jí taky ne .	a tom no le gustaba mary , y a ella no le gustaba él .
neměl jsem se sem nikdy vracet .	no debería haber vuelto nunca aquí .
souhlasím s některými vašimi názory .	estoy de acuerdo con algunas de sus opiniones .
my argentinci nechytáme vlaky nebo letadla a nedostáváme květiny nebo rýmu , jen šukáme s těmi , které milujeme nebo kteří se nám líbí .	los argentinos no cogemos trenes , aviones , flores o resfríos , solo cogemos con aquellos que amamos o nos gustan .
k mému překvapení nedovedla zodpovědět otázku .	para mi sorpresa , ella no pudo contestar a la pregunta .
jsem teď zaneprázdněn psaním knihy .	ahora estoy ocupado escribiendo un libro .
bojí se psů .	él le tiene miedo a los perros .
on se bojí psů .	él le tiene miedo a los perros .
jak se říká tamtomu ?	¿ cómo se llama eso ?
jak se jmenuje tamto ?	¿ cómo se llama eso ?
ona zrovna teď píše knihu .	ahora ella está escribiendo un libro .
neviděl jsem tě celou věčnost .	no te he visto hace una eternidad .
tom pivo příliš nepije , ale rozhodně pije hodně vína .	tom no toma mucha cerveza , pero sí que toma mucho vino .
vídám se tebou tak málo , že bych už tvé rysy zapomněl , kdybych je neustále neviděl ve svém srdci .	te veo tan poco , que me olvidaría de tus rasgos si no los viera siempre en mi corazón .
včera byl čtvrtek .	ayer era jueves .
ona tohle potřebuje .	ella necesita esto .
doufám , že se brzy uvidíme .	espero que nos veamos pronto .
nemám peníze a nemám ani přátele .	no tengo dinero y tampoco tengo amigos .
četl jsem , že prezidentem brazílie je žena . jmenuje se dilma .	he leído que el presidente de brasil es una mujer . se llama dilma .
zavřel za sebou dveře .	él cerró la puerta detrás de él .
můžu mluvit jen sám za sebe .	sólo puedo hablar por mí mismo .
dítě píše knihu .	el niño escribe un libro .
já mám velký hlad .	yo tengo mucha hambre .
nejedl jsem od snídaně a mám velký hlad .	no he comido desde el desayuno y tengo mucha hambre .
od snídaně jsem nejedla a mám velký hlad .	no he comido desde el desayuno y tengo mucha hambre .
jak se jmenuje tento předmět ?	¿ cómo se llama este objeto ?
všechno je mnohem složitější .	todo es mucho más complicado .
ráda bych ho učinila šťastným .	quisiera hacerlo feliz .
rád bych ho učinil šťastným .	quisiera hacerlo feliz .
teorie množin byla vypracována georgem cantorem .	la teoría de los conjuntos fue elucubrada por georg cantor .
to by bylo velmi smutné .	eso sería muy triste .
na trhu byl široký výběr ovoce .	había una gran variedad de frutas en el mercado .
a vím , že jsi to neudělal pro mě .	y sé que no lo hiciste por mí .
schází mi trpělivost .	me falta paciencia .
nedívej se na mě těma tak smutnýma očima .	no me mires con esos ojos tan tristes .
chtěl bych to zkusit .	quisiera intentar eso .
tom se zkusil usmát , ale nemohl .	tom trató de sonreír , pero no pudo .
žádný kandidát ve zkoušce neuspěl .	ningún candidato pasó el examen .
jak se jmenuje tvoje sestra ?	¿ cómo se llama tu hermana ?
když musíš , musíš .	si debes , debes .
milovala je oba a oba milovali ji .	ella los quería a los dos y los dos la querían .
zpráva o těhotenství ji překvapila .	la noticia de su embarazo la tomó por sorpresa .
nemůžu ti říkat , co máš dělat .	no te puedo decir qué hacer .
už tě nemiluju , proto jsem smutný .	ya no te quiero , por eso estoy triste .
došel mi benzín .	me quedé sin nafta .
není ti na blití ?	¿ no tenés ganas de vomitar ?
musíme odejít .	debemos irnos .
tohle chybělo .	esto faltaba .
kdo nic nedělá , nic nezkazí .	quien nada hace , nada hace mal .
nemám vůbec žádný hlad .	no tengo nada de hambre .
řečtina není jednoduchý jazyk .	el griego no es un idioma fácil .
tom nemá rád stejný druh hudby jako mary .	a tom no le gusta el mismo tipo de música que le gusta a mary .
děti utvořily kruh kolem otce .	los niños hicieron un círculo alrededor del padre .
mám rád příběhy se smutným koncem .	me gustan las historias con final triste .
máš-li rád škeble , budeš mít rád chobotnici .	si te gustan las almejas te gustará el pulpo .
neměli bychom utrácet peníze za věci , které nepotřebujeme .	no debemos gastar dinero en cosas que no necesitamos .
ostatní chlapci se usmáli .	los otros chicos sonrieron .
to je kniha o hvězdách .	este es un libro sobre las estrellas .
chyběl dnes někdo ?	¿ faltó alguien hoy ?
chceš , abych to pro tebe udělal ?	¿ quieres que haga eso por ti ?
chcete , abych to pro vás udělal ?	¿ quiere que yo haga eso por usted ?
děti si sedly do kruhu .	los niños se sentaron en un círculo .
děti se usadily do kruhu .	los niños se sentaron en un círculo .
tom má rád mary , ale ona jeho ne .	a tom le gusta mary , pero a ella no le gusta él .
dnes je můj den .	hoy es mi día .
dle mého názoru to není dobrý nápad .	según mi opinión , no es una buena idea .
kdykoliv ho vidím , usmívá se .	cada vez que lo veo , está sonriendo .
pořád se usmívá .	ella siempre está sonriendo .
oba jsme se téměř zároveň začali usmívat .	los dos nos pusimos a sonreír casi al mismo tiempo .
smutně se usmívajíc , začala mluvit .	sonriendo tristemente , comenzó a hablar .
smutně se usmívaje , začal mluvit .	sonriendo tristemente , comenzó a hablar .
nepotřebuji studovat mluvnici , potřebuji slovní zásobu !	¡ no necesito estudiar la gramática , necesito vocabulario !
chci napsat knihu .	quiero escribir un libro .
potřeboval si odpočinout .	él necesitaba descansar .
máš dva květy .	tienes dos flores .
potřebuje jen trochu lásky .	ella solo necesita un poco de amor .
sehnal jsem , co jsem potřeboval .	conseguí lo que necesitaba .
narovnej si záda !	¡ endereza tu espalda !
mám tolik věcí , které nepotřebuju .	tengo tantas cosas que no necesito .
kde je tom , když je ho potřeba ?	¿ dónde está tom cuando se le necesita ?
kde je tom , když ho potřebuješ ?	¿ dónde está tom cuando le necesitas ?
hodiny se zastavily . potřebujou novou baterii .	el reloj se detuvo . necesita una pila nueva .
potřebuješ trochu odvahy říct , že ho miluješ .	necesitas un poco de valor para decir que lo amas .
zůstali jsme tam tři měsíce .	hemos permanecido allí por tres meses .
to není dobré znamení .	esto no es buena señal .
plánujeme tam zůstat týden .	tenemos pensado permanecer allí una semana .
pověděl mi smutný příběh .	me contó un cuento triste .
potřebuju kafe .	necesito café .
existuje naléhavá potřeba kvalifikovaných učitelů .	hay una urgente necesidad de profesores cualificados .
za jakým účelem to potřebujete ?	¿ para qué propósito lo necesita ?
musíš vstát v šest .	tienes que levantarte a las seis .
důvody , které uvedl , jsou těžko pochopitelné .	las razones que expuso son difíciles de comprender .
existuje naléhavá potřeba najít účinnější způsob léčby tohoto onemocnění .	existe una necesidad urgente de encontrar un método más efectivo para tratar esta enfermedad .
kterou knihu potřebujete ?	¿ qué libro necesita ?
kterou knihu potřebuje ?	¿ qué libro necesita ?
kočka ráda rybu , ale nerada si močí packy .	al gato le gusta el pescado pero no le gusta mojarse las patas .
jak se jmenoval ten chlapec ?	¿ cómo se llamaba el niño ?
svět spočívá na zádech veliké želvy .	el mundo se apoya en la espalda de una gran tortuga .
nemohu sám po schodech . jsem starý a potřebuji výtah .	no puedo subir solo las escaleras . soy viejo y necesito un ascensor .
nepotřebuju dějepisnou přednášku .	no necesito una clase de historia .
musím vědět , co se onu noc opravdu stalo .	necesito saber lo que realmente sucedió aquella noche .
právě to jsem potřeboval .	justo eso necesitaba .
musím stisknout knoflík .	necesito pulsar el botón .
dnes mám velký hlad .	hoy tengo mucha hambre .
tohle je třeba změnit .	esto necesita cambiar .
potřebuju trochu duševní stimulace .	necesito un poco de estímulo mental .
fotografie nemůže vysvětlit příčiny .	una foto no puede explicar las razones .
pocházíš z muzikantské rodiny ?	¿ desciendes de una familia de músicos ?
lidé , měl jsem vás rád . bděte !	hombres , los he amado , ¡ estén alerta !
kdykoli mě vidí , dělá že mě nezná .	siempre que me ve , finge que no me conoce .
doobědvals ?	¿ terminaste de comer tu almuerzo ?
je naléhavě zapotřebí dárců krve .	hay una necesidad urgente de donadores de sangre .
je naléhavě zapotřebí pitné vody .	hay una necesidad urgente de agua potable .
je naléhavě zapotřebí peněz .	hay una necesidad urgente de dinero .
někdo v této místnosti potřebuje dobrý deodorant .	alguien en esta sala está necesitando un buen desodorante .
oběd si přinést nemusíš .	no necesitas traer tu almuerzo .
musí být velice smutné pohřbít syna .	debe ser muy triste tener que enterrar a un hijo .
rád bych bílou čokoládu .	quisiera chocolate blanco .
opravdu potřebuješ psychiatra .	verdaderamente necesitas a un psiquiatra .
ty opravdu potřebuješ ženskou .	realmente necesitas a una mujer .
v době nouze budu po tvém boku .	estaré junto a ti en tiempo de necesidad .
mám raději rýži než chléb .	me gusta el arroz más que lo que me gusta el pan .
obědváme .	estamos almorzando .
netvař se na mě tak smutně .	no me pongas una cara tan triste .
nekoukej na mě tak smutně .	no me mires tan triste .
začal jsem psát knihu .	comencé a escribir un libro .
nemohu to krvácení zastavit .	no puedo detener el sangrado .
v případě požáru rozbij tohle okno .	en caso de incendio , rompa la ventana .
vstávej !	¡ levántate !
toma bolí záda .	a tom le duele la espalda .
řekni mu , že mám hlad .	dile que tengo hambre .
řekni jí , že mám hlad .	dile que tengo hambre .
nikdy jsem ti nechtěl ublížit .	jamás quise herirte .
jeho smrt každého zarmoutila .	su muerte puso a todos tristes .
žít je stárnout , nic víc .	vivir es hacerse viejo , nada más .
čínská vláda publikuje denně pět až deset zpráv v esperantu na esperanto . china . org . cn .	el gobierno chino publica diariamente de cinco a diez artículos en esperanto en esperanto . china . org . cn .
piješ zelený čaj ?	¿ bebes té verde ?
strach nemůže existovat bez naděje , ani naděje beze strachu .	el miedo no puede existir sin la esperanza , ni la esperanza sin el miedo .
rád bych doutníky .	quisiera cigarros .
je pravda , že pro studenty by bylo mnohem jednodušší , kdyby existovala jen jedna varianta španělštiny , ale to má ke skutečnosti dost daleko .	es verdad que sería más fácil para los estudiantes si solo hubiera una variedad de español , pero eso dista bastante de la realidad .
všichni chceme , abys byla šťastná .	todos queremos que seas feliz .
podle mne je esperanto velmi důležité .	en mi opinión , el esperanto es muy importante .
umíš plavat , že ano ?	¿ puedes nadar , no ?
práce byla skoro hotová .	el trabajo estaba casi terminado .
nedělej si starosti , dnes je plastická chirurgie mnohem lepší než za časů doktora frankensteina .	no te preocupes , hoy en día la cirugía plástica es mucho mejor que en los tiempos del dr . frankenstein .
miloval jsem tě .	yo te quise .
milovala jsem tě .	yo te quise .
já tě miloval .	yo te quise .
já tě milovala .	yo te quise .
jdu do fukui .	voy a fukui .
láska je důležitá věc .	el amor es una cosa importante .
žiji v miláně .	vivo en milán .
tom neodpověděl na maryinu otázku .	tom no respondió a la pregunta de mary .
latinskoamerický román je charakteristický svými kontrasty .	la novela latinoamericana se caracteriza por sus contrastes .
liszt , příjmení maďarského skladatele ference liszta , znamená mouka v maďarštině .	liszt , como el apellido del compositor húngaro franz liszt , significa harina en húngaro .
mladý chemik se rozhodl založit lékárnu .	el joven químico decidió abrir una farmacia .
má deset dětí .	ella tiene diez hijos .
máš mnoho knih .	tienes muchos libros .
potřebuji tvoji radu .	necesito tu consejo .
máš auto ?	¿ tenés auto ?
to je tvůj problém , ne můj .	es tu problema , no el mío .
budova je vysoká sedm pater .	el edificio tiene siete pisos de altura .
tom potřebuje nové boty .	tom necesita nuevos zapatos .
co bys dělal , kdybych ti byl nevěrný ?	¿ qué harías si yo fuera infiel ?
co bys dělala , kdybych ti byl nevěrný ?	¿ qué harías si yo fuera infiel ?
co bys dělala , kdybych ti byla nevěrná ?	¿ qué harías si yo fuera infiel ?
co bys dělal , kdybych ti byla nevěrná ?	¿ qué harías si yo fuera infiel ?
jeden za všechny , všichni za jednoho .	uno para todos , todos para uno .
jeden za všechny , všichni za jednoho .	uno para todos y todos para uno .
kde jsme ?	¿ dónde estamos ?
to je moje škole .	esa es mi escuela .
jeho rodiče byli učitelé .	sus padres eran profesores .
kde je knihovna ?	¿ dónde está la biblioteca ?
nemám čas číst knihy .	no tengo tiempo para leer libros .
kikirikí ! “ zpívá kohout po ránu .	¡ quiquiriquí ! canta el gallo por la mañana .
a ty ?	¿ y tú ?
mám velkou rodinu .	mi familia es grande .
můj kamarád jí rybu .	mi amigo está comiendo pescado .
chci si koupit ananas .	quiero comprar piñas .
pracuje v bance .	trabaja en el banco .
pracuje v bance .	trabaja en un banco .
některé věty nedávají smysl . no a co ?	algunas frases no tienen sentido . ¿ y qué ?
dejte , prosím , tomovi něco k jídlu .	dele , por favor , algo de comer a tom .
narozeniny jsou důležité .	los cumpleaños son importantes .
dneska mám narozeniny .	hoy es mi cumpleaños .
zítra mám narozeniny .	mañana es mi cumpleaños .
mám narozeniny v listopadu .	mi cumpleaños es en noviembre .
tom potřebuje pomoc .	tom necesita ayuda .
dokonalé !	¡ perfecto !
jsem v londýně .	estoy en londres .
byl za války vojákem .	fue soldado durante la guerra .
zvoní mi telefon !	¡ suena mi teléfono !
jeden z mých přátel tě zná .	uno de mis amigos te conoce .
vždycky cvičila na piáno .	siempre practicaba el piano .
sním ten pomeranč .	yo comeré la naranja .
žádal od nás pomoc .	nos pidió ayuda .
jak se vyslovuje vaše křestní jméno ?	¿ cómo se pronuncia su primer nombre ?
někteří lidé mají rádi léto , a někteří zimu .	a algunas personas les gusta el verano , y a otros el invierno .
kočka má dvě uši .	un gato tiene dos orejas .
kočka má dvě uši .	el gato tiene dos orejas .
proč by i ne ?	¿ por qué no ?
jak jsem to mohl udělat ?	¿ cómo podría hacerlo ?
je na internetu .	está en el internet .
john potkal mary po cestě do školy .	john se juntó con mary de camino a la escuela .
náš učitel je opravdový blbec .	nuestro maestro es un verdadero patán .
to nebylo těžké .	esto no fue difícil .
mám monokla .	tengo un ojo morado .
mám monokla .	tengo un ojo a la funerala .
mám monokla .	tengo un monóculo .
emílie jedla jablko .	emilia se comió una manzana .
tom musel zastavit .	tom tuvo que parar .
už je půlnoc .	ya es medianoche .
internet je hrozně pomalý .	el internet está muy lento .
podíval se na oblohu .	miró al cielo .
jsem teplouš .	soy gay .
nepamatuju se .	no me acuerdo .
nevzpomínám si .	no me acuerdo .
mám ráda čokoládu .	me gusta el chocolate .
děti nemám .	no tengo hijos .
příliš jsi pil .	tomaste demasiado .
mám ti pomoci ?	¿ te ayudo ?
tom a mary hrajou karty .	tom y mary están jugando a las cartas .
můj syn věří na dědu mráze .	mi hijo cree en papá noel .
nikdo nemůže tenhle problém vyřešit .	nadie puede resolver este problema .
uvidíme se zítra !	¡ nos vemos mañana !
italská slovesa se dělí do tří konjugací .	los verbos italianos se dividen en tres conjugaciones .
změňte prosím vlajku .	por favor , cambie la bandera .
jestli potřebuješ slovník , půjčím ti můj starý .	si necesitas un diccionario , te prestaré uno viejo que tengo .
můžu ji požádat o pomoc .	puedo pedirle ayuda .
můžu ji požádat o pomoc .	puedo pedirle ayuda a ella .
omluvil se .	se disculpó .
omluvil se .	él se disculpó .
tento klobouk ti sluší .	ese sombrero se te ve bien .
přines mi ručník .	tráeme una toalla .
bob je můj přítel .	bob es mi amigo .
mám přítele , který je pilotem .	yo tengo un amigo que es piloto .
mám přítele , který je pilotem .	tengo un amigo que es piloto .
hlavní město maďarska je budapešť .	la capital de hungría es budapest .
hlavním městem maďarska je budapešť .	la capital de hungría es budapest .
dnes je studený vítr .	hoy el viento es frío .
kdo půjde s námi ?	¿ quién irá con nosotras ?
říká se , že homér byl slepý .	se dice que homero era ciego .
líbí se mi tamto místo .	me gusta ese lugar .
jím rád koláč .	me gusta comer pastel .
vchází emílie .	emilia entra .
lidé bez humoru jsou jako louky bez květin .	la gente sin sentido del humor son como prados sin flores .
víš , co máš dělat ?	¿ sabes lo que tienes que hacer ?
zapni prosím televizi .	por favor , prende la televisión .
mám čas .	tengo tiempo .
čas mám .	tengo tiempo .
já jsem z tokia .	soy de tokio .
dojím svoji kozu .	estoy ordeñando a mi cabra .
jsem proti manželství .	estoy en contra del matrimonio .
hledám své přátele .	busco a mis amigos .
hledám své přátele .	estoy buscando a mis amigos .
hledám svého bratra .	estoy buscando a mi hermano .
hledám svého bratra .	busco a mi hermano .
japonština je má mateřština .	el japonés es mi lengua materna .
kočka zamňoukala .	el gato maulló .
odpověz !	¡ contesta !
itálie není řecko .	italia no es grecia .
jsi štastný nebo ne ?	¿ eres feliz o no ?
jsi štastný nebo ne ?	¿ es feliz o no ?
je úplně nahý .	está totalmente desnudo .
tom pracuje s námi .	tom trabaja con nosotros .
musíš počkat .	debes esperar .
polib mě .	bésame .
dej mi pusu .	dame un beso .
ježíš bere šeky .	jesús acepta cheques .
putin je čurák .	¡ putin es pura verga !
kdo jsi ?	¿ quién eres ?
tom lhal .	tom mentía .
bůh ochraňuj ukrajinu !	¡ que dios salve a ucrania !
studovali .	estudiaban .
moje srdce přestalo tlouci .	mi corazón dejó de latir .
miluješ sebe sama .	te amas a ti mismo .
miluješ sebe sama .	te amas a ti misma .
řekni mi , co se stalo .	dime qué pasó .
je po létu .	es post-verano .
oni se nebojí smrti .	ellos no le temen a la muerte .
ony se nebojí smrti .	ellos no le temen a la muerte .
nebojí se smrti .	no le teme a la muerte .
nebojí se smrti .	no le temen a la muerte .
ona je angličanka .	ella es inglesa .
tam kde se pálí knihy , posléze se upalují lidé .	ahí donde se queman libros se acaba quemando también seres humanos .
kdo je tvůj oblíbený básník ?	¿ cuál es tu poeta favorito ?
jsem tvůj soused .	soy tu vecino .
jsem hrdina .	soy un héroe .
jeho dům je na prodej .	su casa está en venta .
pacient neměl horečku .	el paciente no tenía fiebre .
to je nezákonné !	¡ es ilegal !
je tom doma ?	¿ está tom en casa ?
víš , že to potřebuješ .	sabes que lo necesitas .
těší mě .	encantado .
začínáme ?	¿ empezamos ?
kouříš ?	¿ fumas ?
věř mi .	créeme .
jdeme .	vamos .
prosím , vyplňte formulář .	por favor , complete el formulario .
jsem unavený , chci spát .	estoy cansado , quiero dormir .
to jsem nechtěl !	¡ no lo quería !
znáš tomášovy rodiče ?	¿ conoces a los padres de tomás ?
jsi šťastný ?	¿ estás feliz ?
potřebuješ klíč , abys otevřel krabici .	necesitas una llave para abrir la caja .
musím psát .	yo debo escribir .
tom nikdy neřekl , že chce jít .	tom nunca dijo que quería ir .
pardon , ale můj otec není doma .	perdón pero mi padre no está en casa .
všichni jsme byli tam .	todos estuvimos ahí .
život tady je mnohem jednodušší , než býval dřív .	la vida aquí es mucho más fácil de lo que lo era antes .
začal cítit strach .	empezó a sentir miedo .
ona je chudá , ale šťastná .	ella es pobre , pero es feliz .
váš otec je lékař ?	¿ su padre es médico ?
jeho otec je lékař ?	¿ su padre es médico ?
její otec je lékař ?	¿ su padre es médico ?
králíci mají velké uši .	los conejos tienen grandes orejas .
dnes je neděle .	hoy es domingo .
musím říct že ne .	tengo que decir que no .
ten obchod je dnes uzavřen .	esa tienda está cerrada hoy .
proč to nemůžeme udělat ?	¿ por qué no podemos hacerlo ?
byl jsem tam ze své vlastní vůle .	fui allá por mi propia voluntad .
šel jsem tam ze své vlastní vůle .	fui allá por mi propia voluntad .
on má dvacet dětí .	él tiene veinte niños .
viděl jsem něco hrozného .	vi algo terrible .
skupina lidí běží po pláži .	un grupo de gente corre por la playa .
jsi ze švédska .	eres de suecia .
tady je moje kamarádka felicie .	aquí está mi amiga felicia .
tom si dal teploměr do úst .	tom se puso el termómetro en la boca .
líbí se vám moskva ?	¿ les gusta moscú ?
nerada bývám sama .	no me gusta estar sola .
moje podprsenka je špinavá .	mi sostén está sucio .
on není učitel , nýbrž student .	él no es un maestro sino un alumno .
nezavírej dveře .	no cierres la puerta .
tom tvrdě spal .	tom estaba profundamente dormido .
můj španělský kamarád se jmenuje enrique .	mi amigo español se llama enrique .
tom byl zneužíván svým otcem .	tom fue abusado por su padre .
nemám žádné nepřátele .	yo no tengo ningún enemigo .
nemůžeme čekat .	no podemos esperar .
prosím , řekni mi pravdu .	por favor , dime la verdad .
článek byl napsán v ruštině .	el artículo fue escrito en ruso .
ona zčervenala .	ella se puso roja .
je kurevské vedro .	hace un puto calor de madre .
zčervenala .	ella se puso roja .
je tady někdo kdo mluví japonsky ?	¿ hay alguien aquí que hable japonés ?
toto je moje práce .	éste es mi trabajo .
ona vůbec není spokojena .	ella no está para nada contenta .
pamatuji si .	yo me acuerdo .
tom umí několik kouzelných triků .	tom sabe unos cuantos trucos de magia .
tom měl dobrý den ve škole .	tom tuvo un buen día en la escuela .
tom už byl opilý .	tom ya estaba borracho .
pes začal běžet .	el perro empezó a correr .
ne , nemám žízeň .	no , no tengo sed .
máš pravdu , jako vždy .	tienes razón como siempre .
ano , mám hlad .	sí , tengo hambre .
ano , mám žízeň .	sí , tengo sed .
kocour je v domě .	el gato está en la casa .
mám hodně knih .	tengo muchos libros .
jaký máme plán ?	¿ qué plan tenemos ?
tom tohle nesnáší .	tom detesta esto .
chci , abys byla upřímná .	quiero que seas honesta .
chci , abys byl upřímný .	quiero que seas honesto .
tom musí něco sníst .	tom necesita comer algo .
chudák .	pobre hombre .
děkuji za odpověď .	gracias por la respuesta .
mamut je fascinující zvíře , škoda že vymřel .	el mamut es un animal fascinante , lástima que se haya extinguido .
čistá voda v řece vybízela ke koupání .	el agua límpida del río daba ganas de bañarse en él .
asi přicházím o hlas po takovém řvaní .	creo que me estoy quedando afónico de tanto gritar .
potřebuji oznámkovat tenhle dopis .	necesito franquear esta carta .
nezačínej si s ním .	no te metas con él .
políbil mě a odešel .	me besó y se fue .
dej mobil nabíjet .	pon el móvil a cargar .
už nemám čas .	no me queda tiempo .
jdi z mé třídy .	vete de mi clase .
všichni jsme zmlkli .	todos nos quedamos callados .
vím , jací jsou muži . chtějí jen jedno .	sé cómo son los hombres . solo quieren una cosa .
žijeme v době , kdy se vše řeší násilím .	vivimos en una época en la que todo se arregla con violencia .
spolu tu krizi překonáme .	vamos a superar esta crisis juntos .
ženy mě nazývají ošklivým dokud nezjistí kolik mám peněz . když to zjistí , nazývají mě ošklivým a chudým .	las mujeres me llaman feo hasta que descubren el dinero que tengo . y cuando lo descubren me llaman feo y pobre .
to není ana .	ella no es ana .
to není ana ?	¿ ella no es ana ?
jmenuje se akie .	ella se llama akie .
jsi ana ?	¿ eres ana ?
ne , nejsem ana .	no , no soy ana .
ano , jsem ana .	sí , soy ana .
psi jsou nejlepší přátelé člověka .	los perros son los mejores amigos del hombre .
to je složitá otázka .	es una cuestión complicada .
byl to významný moment .	fue un momento significativo .
mary je opravdu krásná .	mary es verdaderamente bella .
tom je velmi nebezpečný muž .	tom es un hombre muy peligroso .
je to zkušený profesor .	es un profesor experimentado .
tom je evidentně zklamaný .	tom está claramente decepcionado .
tom je úplně vyděšený .	tom está totalmente aterrorizado .
nevypadáš moc spokojeně .	no pareces muy contento .
ty hory jsou krásné .	las montañas son preciosas .
tři krát pět je patnáct .	tres por cinco son quince .
to co říká rozhodně není pravda .	eso que él dijo no es , en absoluto , verdad .
dan ani nevyplnil ten formulář .	dan ni siquiera llenó el formulario .
co tom říká , není pravda .	lo que dice tom no es verdad .
má jen jednu ledvinu .	tiene solo un riñón .
kniha je malá .	el libro es chico .
už jsme tady .	ya estamos aquí .
jaký jsi měl den ?	¿ cómo estuvo tu día ?
jaký jsi měla den ?	¿ cómo estuvo tu día ?
wc je zdarma .	el baño está desocupado .
viděl jsem mary včera .	ayer vi a mary .
má dlouhý nos .	tiene una nariz grande .
barcelona je ráj katalánské kuchyně .	barcelona es el paraíso de la cocina catalana .
tom má dvě kočky . jedna je bílá a druhá je černá .	tom tiene dos gatos . uno es blanco y el otro es negro .
líbí se mi řeči .	me encantan los idiomas .
děti a opilci nelžou .	los niños y los borrachos no mienten .
nikdy se nevzdávej !	¡ nunca te rindas !
auto je žluté .	el carro es amarillo .
žijeme v krásném městě .	vivimos en una hermosa ciudad .
tato věta obsahuje několik chyb .	esta frase contiene varios errores .
obloha se brzy vyjasní .	el cielo se aclarará pronto .
vzal si moji sestru .	él se casó con mi hermana .
přecházel ulici .	estaba cruzando la calle .
pes náhle na cizince vyskočil .	el perro se movió bruscamente ante el extraño .
pozor , zlý pes !	¡ cuidado con el perro !
tom neměl jinou možnost , než ze své práce odejít .	tom no tuvo más remedio que dejar su trabajo .
je více ?	¿ hay más ?
to kafe ti nechutná ?	¿ no te gusta el café ?
on se nebojí ?	¿ no tiene miedo ?
on nemá strach ?	¿ no tiene miedo ?
proč se bojí ?	¿ por qué tienen miedo ?
proč mají strach ?	¿ por qué tienen miedo ?
nenávidí mě .	ellas me odian .
shledal nemožným to víko zvednout .	le resultó imposible levantar el tapón .
učí se francouzsky dva roky .	ella ha estado estudiando francés por algunos años .
tohle budeš chtít vidět .	vas a querer ver esto .
ta kniha se mu líbí .	le gusta ese libro .
měl jsem velký hlad .	tenía mucha hambre .
bolí mě srdce .	me duele el corazón .
rád si pospím .	me gustaría dormir más .
nikdo nic neříká ?	¿ nadie dice nada ?
je tom naživu ?	¿ tom está vivo ?
následuj mne .	sígueme .
řekni mi , co se musí udělat .	dígame qué hay que hacer .
právě jsem tu fotku udělal .	he hecho la foto ahora mismo .
kam půjdeme dnes na večeři ?	¿ adónde vamos a cenar esta noche ?
kolik máš sester ?	¿ cuántas hermanas tienes ?
kolik sester máš ?	¿ cuántas hermanas tienes ?
mám se dobře , děkuji za optání .	estoy bien , gracias por preguntar .
hodně spěchám .	tengo mucha prisa .
dělají skvělou pizzu .	ellas hacen una pizza deliciosa .
kdo ti řekl tu historku ?	¿ quién te ha contado esta historia ?
tom řekl mary , aby se tím nezatěžovala .	tom le dijo a mary que no se preocupara .
ostrý pepř je můj oblíbený .	la pimienta picante es mi favorita .
dokonalosti se dosáhne ne tehdy , když není co přidat , ale když není co odstranit .	la perfección se consigue , no cuando no hay más que añadir , sino cuando no hay nada más por quitar .
beduíni žijí v poušti .	los beduinos viven en el desierto .
zavři ty zkurvený dveře !	¡ cierra la pinche puerta !
jak se tato vesnice jmenuje ?	¿ cuál es el nombre de este pueblo ?
jaký je rozdíl mezi vesnicí a městem ?	¿ cuál es la diferencia entre una villa y un pueblo ?
už jsou známy výsledky voleb ?	¿ ya se conocen los resultados de las elecciones ?
mám strach ze sov .	tengo miedo a los búhos .
nemám rád kočky .	no me gustan los gatos .
kočka jí chleba .	el gato come pan .
kočka jí chleba .	la gata come pan .
všichni jsme smrtelní .	todos somos mortales .
kdy máš narozeniny ?	¿ cuándo es tu cumpleaños ?
nikdy se nebav s cizími lidmi .	nunca hables con extraños .
co je zítra za den ?	¿ qué día es mañana ?
to je naše škola .	es nuestra escuela .
vlastnictví je krádež .	la propiedad es un robo .
ta kočka je velká .	el gato es grande .
jsem ten nejlepší .	soy el mejor .
musíš se učit mnohem více .	debes estudiar mucho más .
oba moji rodiče jsou učitelé francouzštiny .	mis dos padres son profesores de francés .
pleteš si mne s někým jiným .	me confundes con otro .
budu žít v kambodži .	voy a vivir en camboya .
moje kočka má hlad .	mi gato tiene hambre .
nemám nejmenší tušení .	no tengo la menor idea .
moje kočka je hladová .	mi gato tiene hambre .
tom mě chtěl vidět .	tom quería verme .
historie je učitel života .	la historia es la maestra de la vida .
pes nesnědl maso .	el perro no se comió la carne .
nikdo nechce vědět proč jsme tady ?	¿ nadie quiere saber por qué estamos aquí ?
nemám tužku .	no tengo lápiz .
tom a mary říkali , že tě nechtěli žádat , abys to udělal .	tom y mary dijeron que no querían pedirte que lo hicieras .
vy nemáte strach z duchů , že ?	vosotros no les tenéis miedo a los fantasmas , ¿ verdad ?
on ti může podat pomocnou ruku .	puede echarte una mano .
jsem menší než ty .	soy más baja que tú .
chci vědět , kde ony jsou .	quiero saber dónde están ellas .
nechci toma vidět .	no quiero ver a tom .
účet , prosím .	la cuenta , por favor .
nesmím mluvit , jsem na misi .	no puedo hablar , estoy en una misión .
je nejmladší ze všech mých sourozenců .	él es el menor de todos mis hermanos .
díky za pomoc .	gracias por la ayuda .
bůh má vždy pravdu .	dios siempre tiene la razón .
tohle je například pero .	por ejemplo , esto es un bolígrafo .
chci tento telefon .	quiero este teléfono .
musíme ti něco ukázat .	debemos mostrarte algo .
nemusíš platit za všechno .	no debes pagar por todo .
je to naléhavé !	¡ es urgente !
jaký nádherný den !	¡ qué agradable día !
má dobrý příjem .	él tiene un buen ingreso .
smrt nastala dva dny po hospitalizaci .	la muerte ocurrió dos días después del internamiento .
kdo je smutný ?	¿ quién está triste ?
kdo je ten , který nikdy nepůjde studovat do knihovny ?	¿ quién es el que nunca va a estudiar a la biblioteca ?
mnoho lidí půjde studovat do knihovny .	mucha gente va a estudiar a la biblioteca .
studuje se mi lépe v knihovně než doma .	estudio mejor en la biblioteca que en casa .
už nikdy nebudu studovat v knihovně .	ya no voy nunca a estudiar a la biblioteca .
zítra budu obědvat v kanceláři .	mañana almorzaré en la oficina .
kde je popelník ?	¿ dónde está el cenicero ?
tom a mary nejsou moji rodiče .	tom y mary no son mis padres .
chceš cukr ?	¿ quieres azúcar ?
růst populace je vážným problémem .	el aumento de la población es un problema serio .
začínám rozumět , proč se tomovi líbí boston .	empiezo a comprender por qué a tom le gusta boston .
vaříte vodu , abyste v ní zabili všechny baktérie .	ustedes hierven el agua para matar todos los microbios que existen en ella .
chceš sladkosti ?	¿ quieres unos dulces ?
oženil se s kočkou , co si ji vybral .	él se casó con una chava de su propia elección .
k čemu jsem ?	para qué soy ?
kolik jsi mi ochotna zaplatit , abych to udělal ?	¿ cuánto me pagarías para que lo haga ?
nemohu jim ho dát .	no puedo dárselo .
nemohu jim ho dát .	no se le puedo dar a ellos .
věda je způsobem kladení otázek světu a poslechu jeho odpovědí .	la ciencia es una manera de hacerle preguntas al mundo y de escuchar sus respuestas .
přišel jsem pro zlato a našel hnůj .	vine buscando oro y encontré mierda .
dnes jsem se s tomem opět pohádal .	hoy hemos peleado con tom de nuevo .
mám rychlé auto .	tengo un auto rápido .
igor je špičkový muškař , který se spokojí jen s tím nejlepším .	igor es un pescador de mosca de alta gama quien no se conformará con nada más que lo mejor .
bacha , pes !	¡ cuidado ! un perro .
za koho mě máte ?	¿ quién piensa que soy ?
kdo říká , že ničeho nelituje , říká vlastně : jsem čurák . “	quien dice que no tiene arrepentimientos dice de hecho : -soy un pendejo .
nevypadáš jako někdo , kdo se moc stará o to , co si ostatní myslí .	no pareces alguien que se preocupe por lo que otros piensen .
nemáš větší pánev ?	¿ tienes un sartén más grande ?
pomohla své matce uklizet ten dům .	ella le ayudó a su madre a limpiar la casa .
nakonec jsem vyhrál .	terminé ganando .
čekám , že zítra bude pršet .	espero que llueva mañana .
ona neexistuje .	ella no existe .
obyčejně chodím pěšky .	normalmente voy andando .
madisonovy první čtyři roky nebyly snadné .	los primeros cuatro años de madison no fueron fáciles .
jsem tady s tomem na pomoc .	tom y yo estamos aquí para ayudar .
dobrou noc !	¡ buenas noches !
emily chodí do školy .	emily va a la escuela .
moji rodiče nechtějí , abych každý večer pil pivo .	mis padres no quieren que tome cerveza todas las noches .
proč ne zítra ?	¿ por qué no mañana ?
můj byt je blízko .	mi apartamento está cerca .
potkal ji u dveří .	la encontró en la puerta .
bohužel , můj otec není doma .	desgraciadamente , mi padre no está en la casa .
je čas jít spát .	es hora de irse a la cama .
je čas jít spát .	ya es hora de dormir .
je čas jít spát .	es hora de irse a dormir .
ten nápad se jí nelíbil .	a ella no le gustaba la idea .
nový koronavirus je velmi nakažlivý .	el nuevo coronavirus es muy contagioso .
nový koronavirus je velmi nakažlivý .	el nuevo virus corona es muy infeccioso .
nevrátíme se do normálního stavu , protože normální stav byl problém .	no volveremos a la normalidad porque la normalidad era el problema .
donald trump je patologický lhář .	donald trump es un mentiroso patológico .
když jede do paříže , vždycky spí ve stejném hotelu .	cuando va a parís , siempre duerme en el mismo hotel .
nemám čas na čtení .	no tengo tiempo para leer .
nemusíme tady být .	no tenemos que estar aquí .
on pije pivo .	él bebe cerveza .
ona pije čaj .	ella bebe té .
ona pije kávu ?	¿ ella bebe café ?
mary kouřila .	maría estaba fumando .
díky za pomoc .	gracias por ayudarme .
když budu mít čas , uklidím dům .	si tengo tiempo , limpiaré la casa .
co ? neslyším tě .	¿ qué ? no te oigo .
studovali jste někdy v zahraničí ?	¿ tiene experiencia estudiando en el extranjero ?
jedné věci nerozumím .	hay una cosa que no entiendo .
jestli tom nepůjde , nepůjdu také .	si tom no va , yo tampoco .
rusové žijí v rusku , a němci v německu .	los rusos viven en rusia y los alemanes en alemania .
život mě má rád .	la vida me ama .
jaká je tvoje oblíbená hudební skupina ?	¿ cuál es tu grupo de música favorito ?
toto je řeka ?	¿ esto es un río ?
má málo trpělivosti .	tiene poca paciencia .
je v kuchyni .	está en la cocina .
jsem nespavec .	soy insomne .
naučit se dobře cizí jazyk nějakou dobu trvá .	toma tiempo hablar bien un idioma extranjero .
tom mluví rusky .	tom habla ruso .
je to moc dobrá kuchařka .	ella es una muy buena cocinera .
pracujete dlouho ?	¿ está trabajando hasta tarde ?
mary se zajímá o politiku .	mary está interesada en la política .
cestoval jsem autem .	viajaba en un coche .
mohu použít váš telefon ? samozřejmě !	¿ puedo usar su teléfono ? ¡ no faltaría más !
plavu hodně .	nado mucho .
nepiji kávu ani čaj .	no bebo café ni té .
musím na všechny ty otázky odpovídat ?	¿ tengo que responder a todas las preguntas ?
nevím .	no lo sé .
tom to dělat nebude .	tom no va a hacer eso .
mám pouze tři dolary .	sólo tengo tres dólares .
moje kočka spala vedle mě .	mi gata se durmió a mi lado .
tohle není pro mě .	esto no es para mí .
chci hodně odpočívat .	quiero descansar mucho .
nikdo to nemůže vědět .	nadie puede saberlo .
loňská zima byla velmi suchá .	el invierno pasado fue muy seco .
začal jsem hledat práci tam , kde jsem mohl .	empecé a buscar trabajo donde pude .
tom moc nemluví .	tom no habla mucho .
jsem nezávislý člověk .	soy un hombre independiente .
chci žít v lisabonu .	quiero vivir en lisboa .
nevím , co ještě mám říci .	no sé qué más decir .
tom není malé dítě .	tom no es un niño pequeño .
tohle bych chtěl dělat .	esto es lo que quería hacer .
chce být hvězdou .	quiere ser una estrella .
tom není anarchista .	tom no es anarquista .
kde může ta kočka být ?	¿ dónde puede estar el gato ?
ale mně se nezdál unavený .	pero a mí no me parecía cansado .
kolik mi zaplatíš ?	¿ cuánto me vas a pagar ?
jdu na oběd a pak se vrátím .	me voy a almorzar y vuelvo .
tohle je druhý týden demonstrací .	esta es la segunda semana de manifestaciones .
dnes nemáme vyučování .	hoy no tenemos clase .
dnes nemáme školu .	hoy no tenemos clase .
máš hodně volného času , že ?	tienes mucho tiempo libre , ¿ a que sí ?
chci se rozloučit .	me quiero despedir .
bydlíš tady sám ?	¿ vives aquí solo ?
nebude sněžit .	no va a nevar .
jsou tady všichni ?	¿ están todos aquí ?
chceš to vědět , nebo ne ?	¿ quieres saberlo o no ?
je to dobré , nebo špatné ?	¿ eso es bueno o malo ?
dnes večer se podívám na nějaký film .	esta noche voy a ver una película .
chceš jen to , co je nemožné .	solo quieres lo imposible .
není to špatný nápad .	no es ni mala idea .
nevím , kam se schovat .	no sé dónde esconderme .
tom si balí kufr .	tom está preparando la maleta .
jste nemocen , pane ?	señor , ¿ está usted enfermo ?
řekla , že se mnou chce mluvit .	ella dijo que quería hablar conmigo .
tohle světlo se mi nelíbí .	esta luz no me gusta .
francouzština je moc hezký jazyk .	el francés es un idioma muy bonito .
poznal jsem ho , když jsem byl v paříži .	lo conocí cuando yo estaba en parís .
sportuješ ?	¿ practicas deporte ?
sportuješ ?	¿ hacés algún deporte ?
mluv !	¡ hablá !
mluv !	¡ hable !
jsem biolog .	soy biólogo .
televize má velký vliv na společnost .	la televisión tiene una gran influencia en la sociedad .
on je pracovitý , ale ona ne .	él es trabajador , pero ella no .
řekl jsem tomovi , že je to zmrd a on mě udeřil .	le dije a tom que él era un cabrón y él me dio .
tom ti to řekne .	tom te dirá .
mám jednu přítelkyni , která žije v tokiu .	tengo una amiga que vive en tokio .
kdo mluvil ?	¿ quién habló ?
kdo to mluvil ?	¿ quién habló ?
řekl ano“ .	él dijo que sí .
jsi jeden z příbuzných toma ?	¿ eres uno de los parientes de tom ?
dnes je špatné počasí .	hoy hace mal tiempo .
rozhodla se , že to udělá .	ha decidido que lo hará .
je to důležitá práce ?	¿ es un trabajo importante ?
tom byl minulý měsíc v austrálii .	tom estuvo en australia el mes pasado .
tom je muž , a já jsem žena .	tom es un hombre y yo soy una mujer .
dnes nechce jít do školy .	hoy no quiere ir a la escuela .
má tři dcery .	tiene tres hijas .
všichni se o toma bojíme .	todos estamos preocupados por tom .
čekám tam na tebe .	te espero allí .
máme novou příležitost .	tenemos una nueva oportunidad .
babička pořád zpívá tu samou píseň .	la abuela siempre canta la misma canción .
poslední dobou nečtu romány .	últimamente no leo novelas .
není to takhle lepší ?	¿ no es mejor así ?
chci soukromí .	quiero privacidad .
když budeš něco potřebovat , zavolej mi .	si necesitas algo , llámame .
je to naposledy .	es la última vez .
tohle je ošklivé .	esto es feo .
zelenina je zdravá .	las verduras son sanas .
musíš to udělat .	debes hacérselo .
jsem pedagog .	soy educador .
šli jsme na pláž .	fuimos a la playa .
šly jsme na pláž .	fuimos a la playa .
je to naše tajemství .	es nuestro secreto .
vidím strom .	veo un árbol .
ten strom je starý .	el árbol es viejo .
už to nech .	déjalo ya .
vzbuďte děti .	levanta a los niños .
dneska jsem doma .	hoy estoy en mi casa .
je to pro mě moc důležité .	es muy importante para mí .
tom se každé ráno učí francouzštinu .	tom estudia francés cada mañana .
tom říká , že se nechce učit francouzsky .	tom dice que no quiere aprender francés .
co od ní chcete ?	¿ qué quieren de ella ?
můžeme se naučit mnohé věci společně .	podemos aprender muchas cosas juntos .
rád píšu .	me gusta escribir .
tom nemá televizi .	tom no tiene televisión .
příští týden chci navštívit svého přítele .	la semana que viene quiero visitar a mi amigo .
mohu s tebou sdílet tento stůl ?	¿ puedo compartir esta mesa contigo ?
je snadné se učit toki pona ?	¿ es fácil aprender toki pona ?
mnozí lidé nemají rádi nemocnice .	a mucha gente no le gustan los hospitales .
byla provdaná za bohatého muže .	ella era casada con un hombre rico .
tom byl mrtev .	tom estaba muerto .
jednoho dne zjistím , kdo byli moji rodiče .	un día descubriré quiénes fueron mis padres .
nejsem členem .	no soy miembro .
ocet je dobrý čistič .	el vinagre es un buen limpiador .
nikdy jsem neřekl , že ano .	nunca dije que sí .
ocet je dobrý čistící prostředek .	el vinagre es un buen limpiador .
kolik řečí znáš , tolikrát jsi člověkem .	se vive una nueva vida por cada nuevo idioma que se hable . si solo se sabe un idioma , solo se vive una vez .
mami , já nechci jít do školy .	mamá , no quiero ir a la escuela .
už tam nejdu .	ya no voy más allí .
kolik slov za minutu dokážeš přečíst ?	¿ cuántas palabras por minuto eres capaz de leer ?
kdy jste byli naposledy v cizině ?	¿ cuándo fue la última vez que fuiste al extranjero ?
mohu si pohladit tvoji kočku ?	¿ puedo acariciar a tu gato ?
ta firma se mi líbí .	me gusta la empresa .
vypadá jako žena .	parece una mujer .
já jsem student , ale on ne .	soy un estudiante , él no .
když prší , autobusy mívají zpoždění .	cuando llueve los autobuses suelen retrasarse .
mary tě potřebovala .	mary te necesitaba .
jestli jsi unavený , nemusíš tolik pracovat .	si estás cansado , no deberías trabajar mucho .
mluvím francouzsky a také anglicky .	hablo francés y también inglés .
teď už to vím také .	ahora yo también lo sé .
jaký je tvůj oblíbený slovník ?	¿ cuál es tu diccionario favorito ?
mary říká , že se cítí dobře .	mary dice que se siente bien .
můj starší bratr je na mě moc hodný .	mi hermano mayor es muy bueno conmigo .
nechci s vámi mluvit .	no quiero hablar con usted .
máš štěstí , že máš práci .	tienes suerte de tener trabajo .
nechtějí tady zůstat .	no quieren quedarse aquí .
neustále lžou .	mienten todo el tiempo .
i když pršelo , hráli jsme fotbal .	aunque llovía , jugamos futbol .
jsem lepší , než tom .	soy mejor que tom .
chodíš často do restaurace ?	¿ vas mucho al restaurante ?
musím s tomem mluvit o mary .	debo hablar con tom sobre mary .
věřím svému otci .	confío en mi padre .
chceme zrušit naši rezervaci .	queremos cancelar nuestra reserva .
nejsem zvyklý tohle dělat .	no estoy acostumbrado a hacer esto .
je černý čaj zdravý ?	¿ el té negro es saludable ?
jak se dostaneš domů ?	¿ cómo piensas volver a casa ?
nemám kolo , natož auto .	no tengo bicicleta , mucho menos auto .
tohle se muselo udělat .	esto era lo que había que hacer .
těším se , až s tebou budu zase pracovat .	estoy deseando volver a trabajar contigo .
teď moji nabídku přijímáš ?	¿ ahora aceptas mi oferta ?
nemluvím rusky .	no hablo ruso .
jsi moje sestra .	eres mi hermana .
jsem na tomto světě úplně sama .	estoy totalmente sola en este mundo .
jsi sama .	estás sola .
máš rád bílé víno ?	¿ te gusta el vino blanco ?
na stole pro tebe něco je .	hay algo para ti en la mesa .
děkuji za vysvětlení .	gracias por explicarlo .
proč si se mnou nehraješ ?	¿ por qué no juegas conmigo ?
vybil se mi mobil .	mi celular se murió .
v tomto životě nemůžeme věřit nikomu !	¡ en esta vida no podemos confiar en nadie !
koho zajímá , co si myslím ?	¿ a quién le importa lo que yo piense ?
je to pořád ten samý příběh .	es siempre la misma historia .
chci vědět , kdo vám to udělal .	quiero saber quién os ha hecho esto .
kde je kráva ?	¿ dónde está la vaca ?
chci se naučit hrát fotbal .	quiero aprender a jugar futbol .
kdyby všichni mluvili francouzsky , nebyl by žádný praktický důvod učit se jiný jazyk .	si todos hablaran francés , no habría ninguna razón práctica para aprender otro idioma .
dnes je dost zima , nezdá se ti ?	hoy hace mucho frío , ¿ no te parece ?
proč se jich tak bojíš ?	¿ por qué les tienes tanto miedo ?
mary a tom jsou sourozenci .	mary y tom son hermanos .
budeš se sprchovat ?	¿ te vas a duchar ?
ale nemohu to udělat .	pero no puedo hacerlo .
ale já to nedokážu .	pero no puedo hacerlo .
tom je oční lékař .	tom es oculista .
zítra zůstanu doma .	mañana me quedaré en mi casa .
s tím názorem souhlasím .	concuerdo con esa opinión .
což takhle jít do kina ?	¿ qué te parece si vamos al cine ?
nejím sýr .	no como queso .
tato práce je pro mě ideální .	este trabajo es ideal para mi .
mluvíte všichni francouzsky ?	¿ todos vosotros habláis francés ?
co chceš dělat s tímhle autem ?	¿ qué quieres hacer con este coche ?
přestala kouřit .	ella dejó de fumar .
tom natřel dveře na bílo .	tom pintó la puerta de blanco .
tomovi bylo třináct , když zemřel .	tom tenía trece años cuando murió .
kde plaveš ?	¿ dónde nadas ?
nežiji ve městě .	no vivo en la ciudad .
nemusíš to dělat .	no tienes que hacerlo .
nechceme to dělat .	no queremos hacerlo .
všude je sníh .	hay nieve por todas partes .
obviňují mě .	me están echando la culpa .
teď jsi na mé straně .	ahora estás a mi lado .
proč jsi vstal ?	¿ por qué te has levantado ?
nevrátíme se .	no vamos a volver .
dovolte mi , abych se představil .	deja que me presente .
nemůžeš zůstat celý den doma .	no puedes quedarte en casa todo el día .
nerad se mnou trávíš čas , že ?	no te gusta pasar tiempo conmigo , ¿ verdad ?
co myslíš , že chci ?	¿ qué crees que quiero ?
nemám důvod tě nenávidět .	no tengo motivos para odiarte .
nevím , proč bych tě měl nenávidět .	no tengo motivos para odiarte .
svým přátelům jsem odpustil .	perdoné a mis amigos .
chci tu ženu .	quiero a esa mujer .
to si myslím .	es lo que pienso .
lidé chtějí dýchat .	la gente quiere respirar .
cítíš se být moc starý .	te sientes muy viejo .
připadáš si moc starý .	te sientes muy viejo .
co je mohu naučit ?	¿ qué puedo enseñarles ?
které město je nejnebezpečnější ?	¿ cuál es la ciudad más peligrosa ?
neumím plavat .	no puedo nadar .
tato kniha je lepší .	este libro es mejor .
můj rodný jazyk je čeština .	mi lengua materna es el checo .
jaký jsi měl den ?	¿ cómo fue tu día ?
kde je nejbližší muzeum ?	¿ dónde está el museo más cercano ?
každý má svůj vlastní způsob života .	cada uno tiene su manera de vivir .
rostliny potřebují k životu především vodu a světlo .	las plantas necesitan agua y luz principalmente para vivir .
můj otec nemá rád hudbu .	a mi padre no le gusta la música .
můj otec nemá rád hudbu .	a mi papá no le gusta la música .
nešla sama .	no fue sola .
ráda pije kávu .	le gusta beber café .
proč to nemohu mít ?	¿ por qué no puedo tenerlo ?
nechtěl jsem s ním mluvit .	no quería hablar con él .
není snadné vzdát se neřestí .	no es fácil dejar los vicios .
můj otec je žid a moje matka arabka .	mi padre es judío y mi madre es árabe .
měl bych se učit na zkoušku .	debería estudiar para el examen .
jakým jazykem se mluví ve vaší zemi ?	¿ qué lengua se habla en su país ?
jestli se chceš setkat s frankofoními kanaďany , jeď do quebecu .	si quieres encontrar a francófonos en canadá , ve a quebec .
samozřejmě , že ti pomůžu .	claro que te ayudaré .
rád mluvím o lásce .	me gusta hablar del amor .
uniknu .	escaparé .
uteču .	escaparé .
uteču .	huiré .
uniknu .	huiré .
tyto knihy se nevejdou na polici .	estos libros no caben en la estantería .
nevěř těmto ženám , jsou záludné .	no te fíes de esas mujeres , son unas traicioneras .
chci zůstat v austrálii .	me gustaría quedarme en australia .
studujeme mnoho jazyků .	estudiamos muchas lenguas .
jsem z rio de janeira v brazílii .	soy de rio de janeiro , brasil .
chci cestovat po celém světě .	quiero viajar por todo el mundo .
chci procestovat celý svět .	quiero viajar por todo el mundo .
nevidím velký rozdíl .	no veo una gran diferencia .
musíš jít s námi .	tenéis que venir con nosotros .
proč nechceš , abych ti pomohl ?	¿ por qué no quieres que te ayude ?
naše rodina vánoce neslaví .	nuestra familia no celebra navidad .
vy nemáte telefony ?	¿ no tienen teléfonos ?
v polsku poláci mluví polsky .	en polonia los polacos hablan polaco .
francouzština je jedním z jazyků , které jsem se vždycky chtěl učit .	el francés es una de las lenguas que siempre quise aprender .
dělali jsme co jsme mohli , ale nestačilo to .	hicimos lo que pudimos pero no fue suficiente .
káva a pivo jsou německé národní nápoje .	el café y la cerveza son las bebidas nacionales alemanas .
za mým domem je zahrada .	hay un jardín detrás de mi casa .
nevěděl to .	él no lo sabía .
tento stůl je ze dřeva .	esta mesa es de madera .
číst je důležité .	es importante leer .
musím nahoru .	debo subir .
na tvém věku nám nezáleží .	no nos importa tu edad .
to je můj učitel .	ese es mi profesor .
brzy po ránu zpívají ptáci .	los pájaros cantan temprano por la mañana .
tom nepil vodu .	tom no bebió agua .
sloni pijí vodu .	los elefantes beben agua .
ptáci pijí vodu .	los pájaros beben agua .
teď otevři oči .	ahora abre los ojos .
jsem si docela jista , že tom nemá žádného bratra .	estoy prácticamente segura de que tom no tiene un hermano .
na takové blbosti nemám čas .	no tengo tiempo para esas pamplinas .
i když jsem brazilec , fandím francouzskému národnímu týmu , protože můj děda se narodil v paříži , mám francouzské příjmení , a také proto , že miluji francii .	pese a ser brasileño , soy hincha de la selección francesa por el hecho de que mi abuelo nació en parís y tener un apellido francés , además de porque amo francia .
tom se učí sám .	tom está estudiando solo .
vůbec jsem nevěděl , co mám říci .	no sabía en absoluto qué decir .
jsem pořád zaměstnaná .	yo siempre estoy ocupada .
potřebuji si něco zařídit , takže musím běžet .	tengo que hacer un mandado así que necesito correr .
tenhle tom je katastrofa .	este tom es un desastre .
tato voda je velmi čistá .	esa agua está muy pura .
pomohu ti naučit se dobře francouzsky .	te ayudaré a aprender bien francés .
teď ti to dát nemůžu .	ahora no te lo puedo dar .
tu noc jsem spal dobře .	esta noche he dormido bien .
můj táta je starší , než moje máma .	mi papá es más alto que mi mamá .
udělal jsem to pro svého syna .	lo hice por mi hijo .
můžu , ať už s tebou , nebo bez tebe .	puedo , con o sin ti .
co mi doporučujete jíst ?	¿ qué me recomiendas que coma ?
v troubě je chléb .	hay pan en el horno .
peču chléb .	estoy haciendo pan .
život bankéře je těžký .	es difícil la vida del banquero .
mluví francouzsky .	ellas hablan francés .
je léto , ne zima .	es verano , no invierno .
to je jeho problém .	es su problema .
přečetl jsem tu knihu za dva dny .	me leí este libro en dos días .
tom má nové auto .	tom tiene un coche nuevo .
co tady dělá tvůj počítač ?	¿ qué hace tu ordenador aquí ?
nic nevíš .	no sabes nada .
je čas na vaření .	es hora de cocinar .
proč musíte odejít ?	¿ por qué os tenéis que ir ?
nejsme doma ?	¿ no estamos en casa ?
jdeš spát ?	¿ vas a dormir ?
nechce si ji vzít .	él no se quiere casar con ella .
chce si ho vzít .	ella se quiere casar con él .
chce se za něj provdat .	ella se quiere casar con él .
co mám pro tebe udělat ?	¿ qué quieres que haga por ti ?
co chceš , abych pro tebe udělal ?	¿ qué quieres que haga por ti ?
musím zavolat záchranku .	tengo que llamar a emergencias .
udělám ti chutné , teplé jídlo .	te voy a cocinar una buena comida caliente .
proč je to zakázáno ?	¿ por qué está prohibido ?
můžeš mi říct , kde jsem ?	¿ puedes decirme dónde estoy ?
kolik je , prosím vás , hodin ?	¿ qué hora es , por favor ?
ne , to není moje auto .	no , éste no es mi coche .
nemám domov , kam bych se vrátil .	no tengo hogar al que volver .
jaká slova používáš nejčastěji ?	¿ cuáles son las palabras que más utilizas ?
někteří lidé začínají určité věci měnit .	hay personas que empiezan a cambiar algunas cosas .
chceš si vyměnit místo ?	¿ quieres cambiar de sitio ?
chceš změnit místo ?	¿ quieres cambiar de sitio ?
musíme opustit tento ostrov .	tenemos que irnos de esta isla .
tohle je velmi čisté místo .	este es un lugar muy limpio .
ti , kdož se milují , se nerozcházejí .	los que se quieren no se separan .
ví to ?	¿ lo sabe él ?
ví to on ?	¿ lo sabe él ?
má jednoho psa a šest koček .	él tiene un perro y seis gatos .
prokrastinace je zloděj času .	la procrastinación es la ladrona del tiempo .
jsme manželé , ale nemáme dům .	somos casados pero no tenemos casa .
nevěří ti .	él no te cree .
také bydlím v té čtvrti .	yo también vivo en ese barrio .
to auto jede velmi rychle .	el coche va velocísimo .
dělá , že je nemocná , aby nemusela pracovat .	se hace la enferma para no trabajar .
dítě občas mluvilo ze spaní .	el niño a veces hablaba en sueños .
mohl bych vidět svého syna ?	¿ podría ver a mi hijo ?
ty hvězdy jsou krásné .	esas estrellas son hermosas .
tchaj-pej je hlavní město taiwanu .	taipéi es la capital de taiwán .
moje argumenty jsou správné .	mis argumentos son sólidos .
moje argumenty jsou rozumné .	mis argumentos son sólidos .
nemluvím s ním .	no me hablo con él .
ovoce je velmi zdravé .	la fruta es muy sana .
strýc byl bledý .	el tío estaba pálido .
také jsem ještě mladý .	yo también soy joven todavía .
tchaj-wan se připravuje na čínskou invazi .	taiwán se está preparando para una invasión de china .
proč nepoužíváte kladivo ?	¿ por qué no usas un martillo ?
jsme připraveni vám pomoct .	estamos listos para ayudaros .
je lepší dorazit včas .	es preferible llegar puntualmente .
nemůžeš to udělat sám .	solo no puedes hacerlo .
sám to nedokážeš .	solo no puedes hacerlo .
je mi to fuk .	me vale verga .
voda slouží k zachování života .	el agua sirve para mantener la vida .
voda je pro život nezbytná .	el agua sirve para mantener la vida .
je to celebrita .	es una celebridad .
bylo ti to vysvětleno .	se te había explicado .
vysvětlilo se ti to .	se te había explicado .
chceme tady žít v míru .	queremos vivir aquí en paz .
je to skvělý čtenář .	es un gran lector .
zvládnu to sám .	yo puedo solo .
rozhodl se přestat pít .	él ha decidido no beber .
nevíš , o co přicházíš .	no sabes lo que te pierdes .
neměl jsem tolik jíst .	no debía haber comido tanto .
chci se s tebou vidět v pondělí .	quiero verte el lunes .
máš hlad , tome ?	¿ tienes hambre , tom ?
chci dát méně .	quiero dar menos .
takové situace jsou běžné .	estas situaciones son habituales .
tyhle situace jsou běžné .	estas situaciones son habituales .
předevčírem byl pátek .	anteayer fue viernes .
tom má ruské přátele .	tom tiene amigos rusos .
rád se koupu v moři .	me gusta nadar en el mar .
kdo četl tuto knihu ?	¿ quién ha leído este libro ?
všichni byli spokojeni .	todos quedaron satisfechos .
pracuji stejně tvrdě nebo více než ty .	trabajo tanto o más que tú .
nevím co .	no sé qué .
to nemohu přijmout .	no lo puedo aceptar .
tohle nemohu akceptovat .	no lo puedo aceptar .
je čas na koupání .	es el momento del baño .
teď prší .	ahora llueve .
myslím , že máma právě dočetla ten román .	creo que mi madre acaba de terminar de leer la novela .
musím se vykoupat .	me tengo que pegar un baño .
nemám dost na zaplacení !	¡ no tengo suficiente para pagar !
můj život patří mně .	soy dueña de mi vida .
je to odsud daleko ?	¿ está muy lejos de aquí ?
tenhle muž se mi líbí !	¡ a mí me gusta este hombre !
ráno piji kávu .	bebo café por la mañana .
během týdne má vždycky hodně práce .	durante la semana siempre está ocupada .
proč tak rád improvizuješ ?	¿ por qué te gusta tanto improvisar ?
byl jsem jen zvědavý .	solo sentía curiosidad .
to je důležitý výsledek .	es un resultado importante .
zázrakem jsem naživu .	estoy vivo de milagro .
pomůžu ti , abys skončil dřív .	te ayudo para que termines antes .
chci být ten , kdo se unaví nejméně .	quiero ser el que menos se canse .
otče náš , jenž jsi na nebesích , posvěť se jméno tvé .	padre nuestro que estás en el cielo , santificado sea tu nombre .
tom je vinen .	tom es culpable .
bydlím sám v malém bytě .	vivo solo en un apartamento pequeño .
pracuji za peníze .	trabajo por el dinero .
pracuju pro peníze .	trabajo por el dinero .
advokát jej její bratr .	el abogado es su hermano .
co je to hlava ?	¿ qué es la cabeza ?
tohle je beznadějné .	esto no tiene remedio .
dříve či později na to zapomeneš .	tarde o temprano te olvidarás de ello .
ty tomu nevěříš ?	¿ a que no te lo crees ?
jsi můj oblíbený synovec .	tú eres mi sobrino favorito .
nikdy nekouřil .	nunca fumó .
žlutá květina je krásná .	la flor amarilla es bonita .
myslím , že moje práce nemá smysl .	creo que mi trabajo no tiene sentido .
už tě nezajímají stejné věci jako dříve .	ahora ya no te interesan las mismas cosas que antaño .
kostarika a portoriko jsou dvě velmi odlišné země .	costa rica y puerto rico son dos países muy diferentes .
problémy se vyřeší .	los problemas se resolverán .
moje kočka mě miluje .	mi gato me ama .
nebe je šedé .	el cielo está gris .
vždycky chce vyhrát .	siempre quiere ganar .
tohle pít nebudu .	no voy a beber eso .
ona je bohatá .	ella es rica .
nemůžu tě nechat odejít , je mi líto .	no puedo dejarte salir , lo siento .
nepracuji pro něj .	no trabajo para él .
nejdůležitější je mír .	lo más importante es la paz .
tom je španěl .	tom es español .
teď nemůžu zaplatit .	no puedo pagar ahora .
moře bylo modré .	el mar era azul .
potřebuji lékaře , kde tady nějakého najdu ?	necesito un doctor , ¿ dónde puedo encontrar uno por aquí ?
momentálně ne , díky .	no por el momento , gracias .
teď ne , dík .	no por el momento , gracias .
anna žije ve francii .	anna vive en francia .
šachmat .	jaque mate .
mluvit je dobré , dělat je lepší .	hablar es bueno , hacer es mejor .
mám vše , co potřebuji .	tengo todo lo necesario .
lublaň je hlavní město slovinska .	liubliana es la capital de eslovenia .
nedokážu to pochopit .	no puedo entender esto .
plaveš každý den ?	¿ nadás todos los días ?
nechtějí mluvit .	no quieren hablar .
pláž je prázdná .	la playa está vacía .
je zima .	es invierno .
nemůžu toma opustit jen tak .	no puedo abandonar a tom , así nomás .
chci potvrdit svou rezervaci v hotelu .	quiero confirmar mi reserva en el hotel .
to je loutka .	es una muñeca .
sám to všechno nezvládnu .	yo solo no puedo con todo .
o tomovi kolují zvěsti .	hay un rumor circulando sobre tom .
souhlasím s vaším názorem .	coincido con vuestro parecer .
myslím , že se musím k něčemu přiznat .	creo que tengo que confesarle algo .
proč pláčeš , dcerko ?	¿ por qué lloras , hija ?
nejsem zvyklý mluvit na veřejnosti .	no estoy acostumbrado a hablar en público .
nevím , co mi říkali .	no sé qué me decían .
je nějaká fotka toma ?	¿ hay una foto de tom ?
škola je dál než nádraží .	la escuela está más lejos que la estación .
vypněte si , prosím , svá elektronická zařízení .	por favor apaguen sus dispositivos electrónicos .
tom má sklon přehánět .	tom tiende a exagerar .
budeme se za tebe modlit .	oraremos por ti .
je hrdý na to , že je britským poddaným .	él está orgulloso de ser un súbdito británico .
člověk musí milovat svého bližního .	uno tiene que amar a su prójimo .
výzvu přijímám !	¡ acepto el desafío !
tu záležitost jsme probrali .	discutimos el asunto .
plán se mi zdá vcelku dobrý .	en conjunto el plan me parece bien .
celek je hodnotnější než části .	vale más el conjunto que las partes .
neexistuje pro to žádné vysvětlení .	no hay explicación para esto .
jeden z mých přátel mluví francouzsky dost dobře .	uno de mis amigos sabe hablar francés bastante bien .
jsou zde pouze dva studenti .	solo hay dos estudiantes aquí .
udělala si pití .	ella se preparó una bebida .
není normální , aby foukal tak silný vítr .	no es normal que sople tanto viento .
tuto situaci nechápu .	no entiendo esta situación .
jsme tady znovu .	estamos aquí de nuevo .
včera byla neděle .	ayer fue domingo .
můžete mi říct , kde je nejbližší autobusové nádraží ?	¿ puedes decirme dónde está la parada de autobús más cercana ?
teď už to máš .	ahora lo tienes .
měl problémy s dýcháním .	tenía problemas respiratorios .
měl dýchací potíže .	tenía problemas respiratorios .
jsem hlupák a nevím proč .	soy estúpido y no sé por qué .
jsou dvě .	son las dos .
nepovažuji ho za přítele .	no lo considero mi amigo .
venuše je planeta .	venus es un planeta .
jupiter je planeta .	júpiter es un planeta .
ráda vaří .	a ella le gusta cocinar .
myslím , že jsi docela chytrý , ne ?	creo que eres muy listo , ¿ no ?
do práce chodím vždy včas .	siempre llego a tiempo al trabajo .
led je voda v pevném skupenství .	el hielo es agua en estado sólido .
led je voda v pevném stavu .	el hielo es agua en estado sólido .
už můžu jít domů .	ya me puedo ir a casa .
vladimir si koupil nové auto .	vladimir compró un carro nuevo .
nechtějí to schválit .	no lo quieren aprobar .
další věci se mi líbí méně , než toto .	otras cosas me gustan menos que esto .
teď spíš .	ahora duermes .
tuto firmu vede můj starší bratr .	esa compañía es manejada por mi hermano mayor .
jak si vede továrna ?	¿ cómo le va a la fábrica ?
tomovi se líbí žít na pobřeží , protože je tam mírné klima .	a tom le gusta vivir en la costa , dado su clima templado .
nechtěli ho tam .	no le querían allí .
jak se daří mému synovi ?	¿ cómo está mi hijo ?
co se stane teď ?	¿ qué ocurre ahora ?
odpoledne trávím na gauči .	paso la tarde en el sofá .
mám čisté svědomí .	mi conciencia está limpia .
kdo to ví , ať to řekne .	los que lo sepan , que lo digan .
moje kniha je nová .	mi libro es nuevo .
pavouci nemají uši .	las arañas no tienen orejas .
velryby nejsou ryby .	las ballenas no son peces .
chci to pro vás udělat .	quiero hacerlo por usted .
tato nevýslovná blahosklonnost boha učiněného člověkem , který prolil svou krev , aby vykoupil všechny lidi , byla tím nejsilnějším podnětem , který přiměl církev k tomu , aby se tak horlivě zajímala o propuštění otroků na svobodu .	esa inefable dignación de un dios hecho hombre , vertiendo la sangre por la redención de todos los hombres , era el más poderoso motivo que inducía á la iglesia á interesarse con tanto celo en la manumisión de los esclavos .
vidíte ?	¿ lo veis ?
tenhle chlapík je můj kolega .	este chico es mi colega .
rostliny mají duši .	las plantas tienen alma .
učte se španělsky se zprávami .	aprende español con las noticias .
pomůžeš mi s tím ?	¿ me ayudas a mover eso ?
vladimír spal v posteli .	vladimir durmió en la cama .
kolik má telefonů ?	¿ cuántos teléfonos tiene ella ?
nemůžete dělat všechno .	no se puede estar a todo .
máte více času ?	¿ tenéis más tiempo ?
je to malé .	es pequeño .
náš syn je zatím ve školce , ale příští rok nastoupí do školy .	nuestro hijo todavía está en la guardería , pero el año que viene empieza la escuela .
mohu ti pomoci ?	¿ podría ayudarte ?
znáš toho muže na té fotce ?	¿ conoces a este hombre de la foto ?
chci jen vidět své děti .	solo quiero ver a mis niños .
kdo je tam ?	¿ quién hay ahí ?
jsi můj přítel .	eres mi amigo .
jsi moje přítelkyně .	eres mi amiga .
stále to není čisté .	esto todavía no está limpio .
dočetl jsem tu knihu .	terminé de leer el libro .
nevinnost je krásná věc .	la inocencia es una cosa bella .
kráva bučí .	la vaca muge .
učíme se zkušenostmi .	aprendemos por experiencia .
strávil jsem víkend se svými přáteli .	pasé el fin de semana con mis amigos .
žáby kvákají .	las ranas croan .
mají žáby zuby ?	¿ las ranas tienen dientes ?
jsem bulharka .	soy búlgara .
jsem bulhar .	soy búlgaro .
jsem francouz .	soy francés .
jsem francouzka .	soy francesa .
jeho žena je francouzka .	su mujer es francesa .
jakou barvu má krev ?	¿ de qué color es la sangre ?
mám oči jen pro tebe .	solo tengo ojos para ti .
je ti zima ?	¿ tienes frío ?
tom je hrdina .	tom es un héroe .
ali pil pomerančový džus .	alí bebió zumo de naranja .
tohle se mi nestává moc často .	esto no me pasa con mucha frecuencia .
bratislava je hlavní město slovenska .	bratislava es la capital de eslovaquia .
ve městě je hodně domů .	en la ciudad hay muchas casas .
už je to nezvratné .	eso ya es irreversible .
jak se řekne španělsky kočka ?	¿ cómo se dice «mačka» en español ?
vysvětlete to , prosím .	explícate , por favor .
proč se mi vyhýbáš ?	¿ por qué me evitas ?
proč je krev červená ?	¿ por qué la sangre es roja ?
neexistuje lepší možnost .	no hay otra posibilidad mejor .
tom hraje ve skupině .	tom toca en una banda .
bůh existuje .	un dios existe .
na koho čekáme ?	¿ a quién esperamos ?
zajímá mě zeměpis .	me interesa la geografía .
hlavní město polska je varšava .	la capital de polonia es varsovia .
hlavní město ukrajiny je kyjev .	la capital de ucrania es kiev .
dej mi tisíc polibků .	dame mil besos .
teď se mnou můžeš mluvit .	puedes hablar conmigo ahora .
můžeš se mnou mluvit teď .	puedes hablar conmigo ahora .
věřím v boha .	creo en dios .
měl dceru .	tenía una hija .
jsi v domě u babičky ?	¿ estás en casa de la abuela ?
tchaj-pej je hlavním městem taiwanu .	taipéi es la capital de taiwán .
tchaj-pej je hlavním městem tchaj-wanu .	taipéi es la capital de taiwán .
jaké je hlavní město taiwanu ?	¿ cuál es la capital de taiwán ?
hlavní město taiwanu je tchaj-pej .	la capital de taiwán es taipéi .
yamoussoukro je hlavním městem pobřeží slonoviny .	yamusukro es la capital de costa de marfil .
teď se jim to líbí .	ahora les gusta .
vím , kdo bydlí v tomto domě .	sé quién vive en esta casa .
ty neumíš plavat ?	¿ no sabes nadar ?
někteří lidé pijí hodně vody .	algunas personas beben mucha agua .
neřekl jsem mu ani slovo .	no le dije una palabra .
tom je lingvista .	tom es lingüista .
kristus vstal z mrtvých !	¡ cristo resucitó de entre los muertos !
neustále pršelo .	llovía sin cesar .
to byl můj dům .	aquélla era mi casa .
nikdo pořádně neví , co dělat .	nadie sabe muy bien qué hacer .
matematiku se obvykle učím v noci .	acostumbro estudiar matemáticas en la noche .
je za deset minut dvě .	faltan diez minutos para las dos .
ne .	no .
mám tři přátele , kteří se jmenují tom .	tengo tres amigos que se llaman tom .
mohu jít s tebou .	puedo ir contigo .
jsem ze srbska .	soy de serbia .
zima už se blíží .	ya se acerca el invierno .
